                                                                                                    
                                                                                                    
                                                                                                    
                                                                                                    
                                                                                                    
                                                                                                    
                                     ~                                                              
                                    ###                                                             
                                   ####~                                                            
                                  ####                                                              
                                  ####                     ^^                                       
                                   ~~###                   ^^^       ^^                             
                                      ~#                   ^^^     ^^^^                ##           
                                                           ^^^^^* ^^ ^^                #            
        #                                                   ^^^^  ^^ ^^                ###          
        #                                                   ^^^    ^            ^^     ###          
        #####                ^^^                           ###     ^^^    *^^  ^^^   ## ##          
           ##     ^^^        ^^^                           # #       ^^^ ^^^^ ^^^^   ####           
           ##       ^^^ ^^*  ^^^              ^^^^        ####       ^^^ ^^ ^^^^^    #### ###       
           ##         ^^^^    ^^^^            ^^^^^^ ^^^  #####     ^^^^  ^^^^          #####       
           #           ^^^    ^^^^             ^^ ^^ ^ ^   ####     ^        ^^           ~##       
           ##          ^^     ^^^^##              ^^^^^^    ###     ^^^   ^^^^^                     
           ##                 ^^^  #               ^^^^     ##       ^^^^^^ ^^^^^                   
           ###                ^^^  ###             ^^^       ~       ^^^     ^^^^                   
           ##        ^^^^     ^      #           ^^^^^                       ^^                     
                     ^^^^^^^^^^   ####           ^^ ^^             ^^^^^     ^^ ^^                  
                    ^^^^^ ^^^^  ######        ^^^^^ ^^^            ^^^^^    ^^  ^^                  
                    ^^^^^^^^^^  ####          ^^^ ^^ ^^           ^^^^ ^^   ^^^^^^^                 
                     ^^^ ^^                   ^^^ *^ ^            ^^^^^^^  ^^^  ^^^                 
                    *^^^  ^^^                   ^^^^^^       ##    ^^ ^^^  ^^^  ^                   
                       ^^^ ^^                   ^^^         ~####  ^^ ^^^    ^^^^                   
                         ^^^                    ^^^^        ## ##     ^^   ^^^^^                    
                                               ^^^^^        ####       *^^^^                        
                        ^^^                    ^^^^^         ###        ^^^^                        
                        ^ ^^^^^               ^^^^*          ##          * ^ ^^^                    
                        ^ ^^^^^               ^^^                          ^^^^^   ^^^              
                       ^^ ^^  ^^^             ^                             ^^^^^^^^                
                       ^     ^^^^                                                     ^^^^          
                   ^^^^^     ^^^^                                                     ^ ^^          
                ^^^^^^^^        ^^^                            ##                     ^^^^          
             ^^^^^^^^^            ^                            ##                    ^^^^^          
             ^^^^^  ^^            ^                            ## ~                  ^^^^           
                ^^                ^^^                          ~###                   ^^^           
                ^^               ^^^^                            ~##                ^^^^^           
                                 ^^^^                              ###              ^^^^^           
                                              ^^                    ##              ^^ ^^           
                                            ^^^^^^^^               ##              ^^^              
                                               *^^^^  ^^^          ####            ^ ^^             
                                               ^^^^     ^^^          ~###        ^^^  ^^            
                     ^^         ^^^^^          ^^^^       ^                      ^^^^  ^            
                     ^^     ^^^^^ ^^^^^^                  ^                       ^^^^^^            
                     ^^^  *^^^^^^ ^^^^^^^             ^^ ^^                                         
                       ^^    ^^    ^^^^^^             ^^^^           ##                             
                       ^^          ^^^  *            ^^ ^^           ###                            
                       ^^                            ^^^^^ ##      #####                            
                       ^^                            ^^^   #######~###    ^^                        
                  ^^^                       ###~     ^^^   ## ## ###       ^^^                      
                 ^^^^                       ###~     ^^^^   # ##            ^^     ###              
          #     ^^ ^                    ^^^###       ^^^^                   ^    #####              
          #     ^^ ^^                   ^^^###                          ^^^^^    ## #               
          #~   ^^^  ^                   ^^^                          ^^ ^^^    ## ###               
       ######  ^^^^^^                                                ^^^^^^    ######               
       ########^^ *                                  ^^             ^^             ####             
          #####^^                                    ^^             ^              #####            
          ####  ^                                  ^^^^^^         ^^^   ^^^^        ####            
           ##  *^       ^^^                     ^^ ^    ^^^       ^     ^ ^^        #####           
           ###         *^ ^   ^^              ^^^^^^^^  ^^^       ^     ^^^^          ###           
^^         ###         ^^ ^^^ ^^             ^^^^   ^^^^  ^    ^^^^      ^^^^         ##            
^^                     ^    ^^^^^            ^^     ^  ^^ ^^   ^^^^      ^^ ^                       
^^^                   ^^        ^      ^^^   ^^     ^^  ^ ^^      ^^     ^  ^                       
^^^*                 ^^        ^^      ^^^ ^^^       ^  ^^^       ^^     ^^^^                       
^^^^^^*^^^      ^^   ^     ####^^^^^ ^^^^^^^         ^ ^^^                *                         
^^   ^^^ ^ ^^   ^^^  ^^    #  #    ^^^               ^^^^^                                          
^^       ^^^^     ^^  ^^   #  #     ^^                ^^^                ~                          
^^         ^^      ^  ^^     ####                      ^^                ##                         
                   ^^^^      ####                      ^              #####~                        
                  ^^           ##                    *^^      ^^      #####                         
                ^^^^           ###                    ^  ^^^^ ^^^     ~###                          
                ^^^^^          ###                    ^^ ^^ ^^^^^^      ~                           
                ^*  ^         ####        ^^           ^^^^ ^^^^^^                                  
               ^^   ^^        ###         ^^^           ^^^^^^ ^^                                   
               ^^    ^^     ^^^^   ^^^^   ^ ^^^         ^^^^ ^^^                                    
               ^^     ^   ^^^^ ^^^ ^^^^   ^^^^^ ^^^^      ^^                                        
               ^^    ^^   ^^^^   ^^^^^^^^^^  ^^^^ ^^  ^                                             
                ^    ^^   ^^^^^   ^^    ^^^^^^  ^^^^^ ^                                             
                ^^^^  ^   ^^^^^         ^^      ^^^^^^^                 ^^                          
                 ^^^ ^^   ^^                     ^^^^^                  ^                           
                   ^ ^^                            ^^^                  ^^                          
                   ^^ ^^^                           ^^                  *^                          
                    ^^^^^^                                              ^^                          
                    ^^^^^^                                              ^^^^                        
                    ^^                                                     ^                        
                                                                           ^^                       
                                                                           ^^                       
                                                                       ^^^^^^                       
                                                                       ^^ ^^^^                      
                                                                        ^^^^ ^^                     
                                                                        ^^ ^^^^                     
                                                                            ^^                      
                                                                                                    
