                                                  
                                                  
                                                  
                                                  
           ## ~            ~                      
           ~###           ##~       ~             
   ^^^^  ^   ##           ###      ###    ^^      
   ^^^^  ^^^^#        ## ~###~     # #    ^^      
     ^^   ^^^#      ####                  ^^      
    ^^    ^^^       ## #      ^^^^         ^^^^ ^^
    ^^   ^^         ####  ^^^  ^^^         ^^^^^^^
                    ##      ^    ^^^       ^^^ ^^^
                     ##     ^^  ^^^^ ^^        ^^ 
                            ^^  ^^^^^^^        ^^ 
                      ^ ^^^ ^         ^           
                    ^^^ ^^^ ^^        ^^          
                   ^^   ^^^ ^^        ^^          
                  ^^    ^^^                       
                  ^^                              
       ^^                                         
     ^^^^                                         
     ^ ^^^                                        
       ^ ^  ~                    #####^^^^^^^     
     ^^^^^###      ^^           ^ ####^^^^^ ^     
    ^^^ ^^###      ^^          *^^  #  ^^^^ ^     
    ^^^  ###        ^         *^^^ ##  ^^^^^^     
    ^^^  ##        ^^          ^^^                
      ^^###     *  ^           ^^^                
      ^^##      ^^^^         ^^                   
        ~# ##   ^^^    ^^^^^^^*            ^^^^   
        #####    ^^    ^ ^^                ^^^^   
        # ##     ^^    ^^             ^^^    ^^   
        ###             ^^    ~ ##    ^ ^    ^^   
     ^^  ##             ^^   ####       ^^^^^^^   
^^   ^^                 ^      ##       ^^^^^^^^  
^^^^^^^^    ###^^                         ^ ^^^^  
^^^^^^^^    ###^^                        *^^^^^^  
 ^^* ^*     ###^^                       ^^^^ ^    
^^^         #^^^                           ^^^    
^^^        ##^  ^^                       ^^       
  ^        # ^ ^^^                  ^ ^^^^^       
 ^^        # ^^^^^                  ^ ^^^^^       
 ^^             ^^            ^   ^^^  ^^         
 ^^             ^^ ^^^^     ^^^   ^*  *^^^        
 ^    ^^        ^  ^^^^^^^  ^     ^^^ ^^^^        
 ^^^^ ^        ^^        ^^^^      ^^ ^^          
    ^^^        ^^   ^    ^^        ^^             
                ^^  ^               ^  *          
                 ^^^^               ^^^^          
                  ^^                 ^^           
