                                                                                                    
                                                                                                    
                                                                                                    
                                                                                                    
                                                                                                    
                                                                                                    
                                                                                                    
                                                                                                    
                                                                                                    
                                                                                                    
                                         ^^^^^                  ^^^^^                    ^^         
                        ^^*             *^^^^^^^^               ^^^^^                    ^^^^       
              ^^        ^^^^             ^^^^^^^^^^                 ^^^^^                ^^^^       
              ^^^       ^^*^                 ^^^*^^^^^                ^^^               ^^^^        
           ^^^^ ^^     ^^^^                      ^^^^                 ^^^               ^  ^        
         ^^^ ^^^ ^     ^^^^                       ^^^    ^^                             ^^^^        
         ^   ^^^ ^^      ^^                              ^^                             ^^^         
       ^^^     ^^^^           ###                       ^^^                           ^^^^^^        
       ^       ^^             #~#                  ^^^^^^^^                           ^^^^^^        
^^   ^^^^                     ###                  ^^ ^^ ^^^^*                        ^^ ^^         
^^^^^^^^^                     ##                    ^^^^   ^^                        ^^^            
^^    ^^^^ ^^              ## #                      ^^^   ^^      *^^^^             ^              
^^      ^^ ^^^             ####                       ^^   ^^       ^^^^^      ^^   ^^              
^^^     ^^^^ ^             ###    ^^                  ^               ^^^      ^^   ^               
        ^^  ^^ ^^*          ##   ^^^                  ^        ##### ^^^^     ^^^^^^^               
    ^^  ^^ ^^  ^^          ##    ^^^                           ##### ^^^^   ^^^^^^^^^               
    ^^^^^  ^^^*^^          #                              ^^   ##### ^^    ^^^^^^^^^^  ###          
    ^^^^^    ^^^^        ###                              ^^^^^^^ ~       ^^^^^ ^^^^  ## #          
    ^^                   ##                               ^ ^^^^^         ^^^^^ ^^    ####          
    *                  ####      ^^^                    ^^^ ^^^^^^         ^^^^      ####           
                       # #        ^^        ^^^^^       ^^^^ ^^^^^         ^^        ####           
                       # #     ^^^^^        ^^^^^^       ^^^^^^^^^                   ##             
           #           ###     ^^  ^        ^^^^ ^^^        ^^^^^^                                  
####       #            ###     ^*^^              *^           ^^^                                  
######   ###            ###     ^^^                ^^          ^^^                                  
#### #   ##########   #######                                                                       
######~  #### ## ##   #     ###                                                                     
    ##   ~ ##### #    ###    ##   ^^                                                  ###           
     ##     ~  ###      ###       ^^              ~##                                 # #        ## 
      #                   #      ^^^^           ####                                  ######      # 
      ##                  #      ^^^^^          ##                                     ## ####### ##
      ~#                           ^^^           #                                     ## ##########
       ##  #                        ^^          ##                                     #   #####    
        ####                ^^                  ##            ^^                            ## ~    
                            ^^                   ####         ^^^        ^                          
                        ^^^^^^^                  ##~##        ^ ^        ^                          
                        ^^^^^^^                     ###      ^^^^        ^^^^^^       ^^            
                        ^^^^^^^                     # #      ^ ^           ^^ ^^^^^^^  ^^           
                        ^   ^^^                     ###    *^^ ^^              ^^^ ^^^  ^^          
                        ^^     ###                          ^  ^^              ^^^ ^^^   ^          
                               ####   ^^                   ^^  ^^                 ^^^   ^^          
         ^^^                   ## #   ^^                   ^^^^^^^^               ^^^   ^           
         ^ ^                      ##^^^^               ^^    ^^^ ^^                   ^^^           
        ^^^^                 ##  *^^^ ^^               ^^    ^^^ ^^                ^^^^             
        ^^^                  ####*^^^^^^                ^^^       ^^         *^^   ^^^              
         ^^^                 #### ^^^^^^                  ^^^     ^^          ^^^^^^^^              
        ^^ ^                  ### ^^^^^                                       ^^^^^^^               
        ^^                    # ####                                            ^^^ ^               
         ^                  ### ####            ~#~##                             ^^^               
         ^^^ ^^^            #   ## ##            ####~                                              
           ^^^^^            #    ####            ####                                               
              ^^      ## ####    ###            ~####                                               
              ^^      ####      ##               ##      ^^^^^                                      
    ^^^^^^    ^      ###        #                        ^^^ ^                                      
    ^^^  ^^  ^^      ###                                 ^^^ ^^^                                    
    ^^^   ^^^^       *                                   ^^^   ^                                    
      ^   ^^       ^^^^                             ^^  ^^    ^^*                                   
      ^^  ^^       ^ ^^                            ^^^^^^     ^                                     
       ^^^^^^      ^^^^                            ^^^^       ^                                     
        ^^  ^^      ^^^                                   ^^^^^                        ^^^^         
             ^        ^                                   ^^^^                         ^^^^         
             ^        ^^                                   ^^^^^                       ^^^^^        
             ^^^       ^^            ^^                  ^^^^^^^               ###    ^^^ ^^        
               ^^       ^          ^^^^^^^               ^^^^^^^   ^^         ~#~     ^^^^^         
                ^        ^^^^      ^ ^^^^^^                ^^^^^^^ ^^  ^^^     #     ^^^^^          
                ^           ^^     ^^^^^^^^               ^^ ^^^^^^^^^^^^^           ^              
                ^^^         *^      ^^^^^^^        ##~##   ^^^  ^^^^^^^^^                           
              ^^^^^          ^^^^^       ^^        #####          ^^ ^^ *                           
            *^^^^^^           ^^^^^      ^        ######                                            
             ^^^^^^  ^^^^     ^^^^^      ^        #####                ^^                           
             ^^      ^^^^     ^^          ^^^      ###    ~            ^^^^^                        
                      ^^                ^^^^^^           ###        ^^^^^^^^^^      ^^              
                     ^^^^               ^^^^             ###        ^^^^^^^^        ^^^             
                     ^^^^             ^^^^^^^            ###         ^^^^^^^       ^^^^             
       ####          ^^^^             ^^  ^^^            ####     ^^^^  ^^^^^      ^^^^             
 ~##   ####            ^^              ^^^^ ^            ## #     ^^^ ^^^^^ ^                       
  ##   ##             ^^                 ^^ ^^           ####       ^^^ ^^^ ^                       
#########             ^                     ^^           ##~              ^^^                       
##### ###                                   ^^^^         ####                                       
##  ##                                        ^^           ##                                       
### ##                                       ^^          ~##                                        
  ####                               ^^^     ^          ###                                         
   ###                          ^^^^ ^ ^     ^^         ###                                         
                                ^^ ^^^ ^^^^   ^         ####                                        
                              ^^^^     ^^^^   ^^                                                    
                              ^ ^^     ^^^^^^^^^                                                    
                              ^       ^^^^^  ^^                                                     
                              ^      ^^^^^^                                                         
                                     ^^^                                                            
                                                                                                    
