                                                                                                    
                                                                                                    
                                                                                                    
                                                                                                    
                                                                                                    
                                                                                                    
                                                                                                    
                                                                                                    
                    ^^^                                                                             
                  ^^^^^                                                                             
              ^^^ ^ ^^            ####                                            #                 
              ^ ^ ^^^^           ~#  ## ###                                       #~                
              ^^^   *^^^        ### ### ####                  ^^                  #                 
              ^^                #####    ###         ^^       ^^^^             ~###                 
             ^^^                #####                ^      ^^^^^^              ###                 
            ^^*^^                 ###          ^^^^  ^    ^^^^^^^^    ~###      ###                 
            ^^^^       ^^        ~###          ^^ ^^^^    ^^^^^^^      ###                          
            *         ^^^         #           ^^^   *     ^^^^ *       ##                           
                      ^^^       *   ^^        ^^^                     ~##                           
                 ^    ^^^      ^^^^^^^^^                           #####                            
                 ^^^^^^^^      ^ ^^    ^^                         ####                              
                ^^^  ^^        ^^^      ^                         ####                              
                ^^^           ^^^^    ^^^                                                           
                              ^^^     ^                                                             
           ^^                  ^^     ^^^                                    ^^^^                   
           ^^                  ^        ^                                    ^ ^^                   
 ^^^^^ ^^^^^                   ^^^      ^                                    ^ ^^^^                 
^^^^^^ ^^^                     ^^^^     ^^^                                  ^^^^^^                 
^^^^^^^^                       ^^^^       ^^                                                        
^^^^^^^                        ^^^^        ^^^                                                      
^^ ^^ ^^^^                                 ^^^                      ^^                              
 ^^ ^^^^^^                                 ^^^ ^^^      ^^           ^^^                            
  ^^^^^^^                                    ^^^^^      ^^           ^^^^^                          
       ^^                                     ^^^^      ^          ^^^^^^^                          
                           ##                  ^^^      ^^         ^^^^^^^                          
                           ###               ^^^^        ^^^        ^^*  *                          
                           ####              ^^^^                                       ^^^         
                            ###              ^                            ##            ^^^         
                             ##              ^^                         #####            ^^         
                            ~#                ^                      ###### #            ^^         
                            ##~               ^^^                    #  #####           ^^^         
                  ^^^       ##                 ^^                    ####~            ^^^^^         
                  ^^^        #                 ^                  **   ####           ^             
                   ^        ##                 ^^                 ^^   ####                         
                   ^^       ##                 ^^                 ^^   ##                           
                   ^^        #                 ^                 ^^    ##                           
                   ^         ~                 ^^                ^   ###     ^^             ^^      
                ^^^^                            ^^^              ^^^  ## ^^^ ^^^^          ^^^      
                ^^^                            ^^^^               ^^     ^ ^^^^^^^         ^^^^^    
                ^                              ^^^^*              ^^     ^ ^^^^^^^*         ^^^^    
              ^^^^^                             ^^^               ^^     ^^^^^          ^^^^^ ^^    
              ^^ ^^                             ^^^    *          ^^     ^^ ^^        ^^^^^         
            ^^^^^^                              ^^    *^^            ^^^^^  ^         ^^^^^^        
            ^^^ ^^    ^^                        ^^     ^^            ^^^^^^^^ ^^      ^^^  ^        
      ^^     ^^ ^^^^^^^^                       ^^^  *^^^^            ^^^^     ^^      ^    ^        
      ^^^^   ^^^ ^^  ^^^  ^^^^^^*              ^  ^^ ^^^^                     ^^     ^^   ^^        
      ^ ^^ ^^^^^ ^^    ^^ ^^^  ^               ^^^^^   ^^^              ^^^^^  ^     ^^   ^         
      ^^^^^^^           ^^^^^  ^^                  ^^^ ^^^              ^^^^^ ^^      ^  ^^         
       ^^  ^^          ^^^^^^   ^^                 ^^^                  ^^^^^ ^     ^^^  ^          
                       ^ ^^^^^  ^^                ^^^^^                 *  ^^^^     ^^^^ ^^         
           ###         ^^^ ^^^  ^^^^^^^^^^        ^ ^^^                  ^^^^^      ^^ ^ ^^         
           ###             ^^   ^^^^ ^^^^^^^      ^^                     ^^ ^^^        ^^^          
            ######         ^^     ^^ ^^^^^^^^      ^^^^                  *^ ^^^                ^^^^ 
            ### ##                    ^^  ^^^         ^                   ^^^                  ^^^^ 
            #####~                             ^^^^^^^^                    ^^                  ^^^^ 
            ##                                 ^ ^^^^^^                                        ^^^^^
                              ###            ^^^ ^^^^^^             ~##                        ^^^ ^
                              ###            ^      ^^           ~## #        ^^^^        ^^     ^^^
                              ###           ^^      ^^           ~#####     ^^^^ ^     ^^^^^    ^^^^
                                            ^^                   ~#####     ^^^^ ^^^^      ^^ ^^^   
                                             ^           ####      ###      ^^^^^^^^^       ^^^^^   
                                          ^^^^          #####      #####     ^^^^^^^        ^^      
                                          ^^^         #######                ^^^  ^^^               
                                    ^^^  ^^^^         ######              ^^^^^^  ^^^               
        ^^^                       ^^^^^  ^^^^^        ##                  ^^^ ^^                    
        ^^^                       ^^ ^^^^ ^^^^        ##                 ^^        ##               
      ^^^^^                       ^^   ^^^^   #########                  ^^        ### ##           
      ^^^*             ~               ^^^      ## ####  ^^^             ^^        ### ##           
      ^             ####                        ####  #  ^^^           ^^^          #####           
     ^^             ## #                          #####  ^^           ^^            ##  ##          
     ^^^^          #####                        ####                                 #   ###        
        ^^^^       ####                         ####                                       ###~     
           ^^      ####                                                          ~#        ###      
           ^^         #                                                           ##       ####     
           ^          ##                                          ~               ##          #     
           ^^          ##                                         ###                 ####    #     
           ^^^^         ##                                        # ##                ## #   ##     
           ^^^^          ##                  ^           ^*      #####                 # #####      
              ^        ## #                  ^           ^^      #####                ##  ###       
          ^^^^^^       ##~##               ^^^^^^         ^      #####                #######       
          ^^^^ ^^^^  ^^ ####               ^^^^^^         ^^                               ##       
          ^^^^^^^ ^^^^^   ##                   ^          ^^^^^                             #       
            ^ ^^^^ ^^^^^                       ^^         ^^^^^                             ##      
            ^^^^^^ ^^^^^                        ^          ^^^^                              ###    
            ^^^^^^^^^^                          ^  ^^^     ^^^^                              ###    
            ^^^^^^^^^^                          ^^^^^^     ^^                                ###    
              ^^^^^^^                           ^^^^^                                        ###    
                ^^^                             ^^^^^^                                              
                ^^                                 ^^^                                              
                                                    ^^                                              
