                                                                                                    
                                                                                                    
                                                                                                    
                                                                                                    
                                                                                                    
                                                                                                    
                                                                                                    
                                                             ^^^^                                   
                                                             ^^^^                                   
                                                            ^^ ^^ ~                                 
                                                            ^     ####                              
                                                          ^^^     ##~#                              
                ##                                      ^^^        #####                            
                ##                                     ^^           #####                           
                #                                      ^           ######                           
                ##                                    ^^           ######                           
                 #                                    ^              ##                             
                 ##    ^                           ^^^^           ^^    ^^                          
                  ###  ^^                          ^^^            ^^^  ^^^ ^^                       
                    ##  ^^^                        ^^^              ^ ^^ ^^^^                       
                    ##    ^                        ^^               ^ ^   ^^^^^^                    
                   ###### ^^                        ^^              ^^^      ^^^                    
                   #### ##^^             ^^^ ^^                              ^^^^                   
            ^^  ^     ####^              ^ ^^^^                               ^^^                   
           *^^* ^         ^^         ^^  * ^^ ^*^^^                       ^^                        
           ^^^^^^         ^^         ^     ^^ ^^^^^                      ^^^                        
           ^^^^           ^^        ^^        ^^^^                      ^^ ^                        
          ^^^^^            ^        ^^        ^^^^                      ^^^^^^ ^                    
          ^^^              ^         ^^        ^             ^^^          ^^^^ ^^^                  
          ^^^          ^^^            ^^    ^^^^*             ^^          ^^^^ *^^                  
                       ^^^             ^    ^^     ##         ^^          ^^^^ ^^                   
                 ^^^    ^^             ^^^^^^^     ####        ^^ ^^^^      *^^^^                   
                 ^^^^^^^^^^^^^^         ^^         ####         ^^^^^         ^^^                   
                      ^^ ^^^^^^        ^^^         ~####### ~     ^^^^       ^^^^                   
                         ^^^^^^        ^^^            #######     ^^^^       ^^                     
                            ^^         ^^             ####        ^^^^                  ^^    ^^^   
                            ^^                         ~       ^^                    ^^^^^^^  ^^^   
        ##                  ^^                                ^^^^^^                 ^^^^^^^  ^     
        ##                                   ##              ^^^^  ^^^          ^^  ^^^^^^^^  ^^*   
        ###~      ^^                         ##              ^^^^   ^^          ^^  ^      ^^ ^^    
        #####    *^^^                         ##           ^^ ^^^   ^^^^       ^^^ ^^       ^^^     
        #####  ###^^^                          ##           ^^^       ^^     ^^^ ^^^                
        ####   ###^^^                          ##            ^^   ^^  ^^    ^^^^                    
        ####   ###                             ###         ^^^    ^^^^^^    ^                       
                ##                               ##       ^^^^   ^^                     ##          
                                                          ^^^^   ^                      ##          
                             ^  *           ^^^              ^^^^^                     ###          
                             ^^^^^^         ^^^  ^^          ^^                       #### ~##  ##  
                               ^^^^          ^^^ ^^^                                  ############  
                               ^^^^*         ^^^^^^^                                  ### ~##   ##  
                 ##   ##       ^^             ^^^^^                                ######           
          ###    #### ##                      ^^             ^^                    #####            
         ~# ~    #  ###~                                    ^^^                    ##               
         ##      ## ####                                    ^^^                 ^ *^^^              
      ####       ##~# ##                                    ^^^              *^^^ ^^ ^              
      ####     ###  ###               ^^                      ^^           ^^^^^^ ^ ^^              
       ###      ##   ##               ^^                      ^^          ^^^^ ^^^^^^               
        ~                    ^        ^^^                     ^^       *^^^^^^^^^^^^^               
                             ^        ^^^                      ^     ^^^^^^^    ^^^^^               
                             ^         ^^      ##              ^^      ^^^^     ^^^^                
                            ^^         ^       #               ^^       ^^^^    ^^^^                
                          ^^^         ^^       #~              ^^^         ^  ^^^      ^^^^         
                          ^^          ^^       #              ^^^^        ^^ ^^^^      ^^^^         
                           ^           ^                      ^           ^^^^ ^      ^^ ^^         
                           ^^^                              ^^^           ^^^ *^^     ^             
                           ^^^          ^^^^^^              ^             ^^^^  ^^^  ^^             
                           ^^           ^^^  ^  ^^^         ^^             ^^^    ^^^^              
                           ^^           ^^^^ ^  ^ ^^        ^^                      ^^              
                                         ^^^   ^^ ^^       ^^                                       
                                           ^^  ^  ^        ^^                                       
                                            ^^^^  ^^                                                
                                            ^^^    ^                                  #             
                                            ^^^   ^^                                  #             
                                                  ^                                 ###~            
                           ##                  ^^                      *            ### ###         
                           ~#                  ^^^^                   ^^            ##### #         
                           ##                  ^^^^                 ^^^^           ###~  ##         
                           ###                * ^^^                 ^^            ## ######         
                             #                ^^^^^                  ^            ####  ###         
                    ##~###   ####             ^^^^^^                 ^                              
                    ######  #####             ^^^^^^                 ^^                             
                     ## ##  #   #             ^^^^^           ~##    ^^^^                           
                            #####           ^^^              #####   ^^^^                           
               ^^^ ^^^^      ###           ^^                ~####     ^^                           
               ^ ^ ^^^^* ^^  ###         ^^^                  # ## ^^^^^                            
               ^^^   ^ ^^^^             ^^                    ###  ^^^^^                            
               ^^^   ^^^  ^             ^^                       ^^^^^                              
            ^  ^^^      ^^^                                      ^^^                                
            ^^^^^     ^^^^^^                                       ^^^                              
             ^^ ^     ^^^^^^                                         ^^^                            
            ^^^^^     ^^  ^^                                          ^^                            
            ^^^       *   *                                           ^                             
                                                                      ^^^                           
                                                                     ^^^^                           
                                                                     ^^^                            
                                                                                                    
                                                                                                    
                                                                                                    
                                                                                                    
                                                                                                    
