                                                                                  ##                
                                                                                  ####              
                                                                                  ##~##             
                                                                                  #####             
                     ####                                                         #####             
                     # ##                                                         ###               
                    ## ####                                                      ##                 
                    #  ## #                                                      #                  
                    ##### #                                                   ####                  
                    #######    **                                             ###                   
                    #          ^^^               ###                  ^^^       ##                  
^^               ^^ ####       ^^^            ######                  ^^^                           
^^^^^^^       ^^^^^  ###       ^^          ## ### ##                  ^^^                           
^^ ^^ ^^      ^  ^^  ##         ^          ## ##                     ^^ ^       ^^                  
^^ ^^       ^^^                ^^          ### #~                    ^^^^       ^^^^^               
^^^^^^^^ ^^^^        ^^        ^           ######               ^^              ^^^^^               
^^     ^^^       ^^^  ^        ^^           #####       ##     *^^^             ^^^^^               
               ^^^*^ ^^         ^             ~          #      ^^^^            ^^^^                
               ^ ^^^^^      *^^ ^                    #####       ^^^                                
             ^^^ ^^^^^^^    ^^^^^                 #######  ^^^    ^^                          ^^    
             ^   ^^^^^^^    ^^^^^*                ### ###^^^^^   ^^                          ^^^    
             ^^    ^^^^     ^^  ^^                 ##    ^^ ^^^  ^  ^^^                      ^^^^   
             ^^       *                           ##      ^ ^^^^^^^^^          ^^^            ^^^^  
             ^^                ^                  #       ^^^     ^^           ^^^             ^^^^^
             ^^               ^^                           ^^      ^^      ^^    ^            ^^^^^^
             ^^^              ^^             ^                             ^^^^^^^            ^^^^^ 
             ^^^              ^^             ^                            ^^   ^^^           ^^     
               ^              ^             ^^                            ^  ^^^ ^           ^^^    
                             ^^             ^                           ^^^  ^^ ^^ ^^^^^      ^^    
                     ^^      ^^^^           ^^                          ^^^   ^ ^ *^ ^^^      ^     
                   ^^^^       ^^^           ^^                          ^^^^^^^ ^^^^ ^^^^   ^^^     
                 ^^^^^^        ^^           ^^       ^^^               ^^^^^^   ^^      ^^^^^       
                 ^^^^^^^       ^^         ^^^^^^     ^^^               ^^ ^^             ^^         
                 ^^^  ^^   ^   ^^         ^^   ^     ^^^                ^^                          
                 ^^^  ^^^  ^   ^^          ^^  ^^    ^^^             ^^^^^          ^^              
       #  ##            ^^^^ ^^^^           ^^ ^^    ^^^             ^ ^^           ^^^             
       #####              ^^ ^^^             ^^^     *              ^^ ^^           ^^^             
         ###                   ^       ^^^            ^^            ^^^^           ^^^^^            
         #####             ^  ^^       ^^^            ^^^            ^^^           ^^^^^^           
           ###             ^^^^     ^^^^^^           ^^^^            ^^^              ^ ^           
           ###              ^^*     ^^ ^^^           ^^^^           ^^                ^^^           
           ##               ^^     ^^^^^^^^           ^^^           ^^                              
            ###                 #  ^^^^ ^^^           ^^            *                               
             ~##                #                     ^^               ^^^^^                        
               ##               ##                    ^                ^^^^^                        
                #               ##                    ^^^^             ^^^^                         
                ##       ^^^    ### ###                 ^^             ^^^  *        ^   ##         
                         ^^^    #######                 ^^^              ^ ^^        ^  ###         
                     ^^  ^^^         ##                   ^*             ^^^^        ^  ###         
                     ^^^^^^^         ##                   ^^   ^^         ^^^*       ^^####~        
                     ^^^ ^^                              ^^^   ^^^       ^^^         ^^             
                     ^^   *                              ^^^^^^^^^^^     ^^^        ^^              
                     ^^                                   ^^^^^^^^^^     ^^         ^               
                    ^^             ^^                    ^^^^     ^^^     *         ^^              
                    ^             ^^^                           ^^^^^          ^^^   ^^             
                    ^             ^^^                           ^^^^         ^^^^^   ^^             
                    ^^            ^^^    ^                      ^^^       *^^^^^^^^^^^              
                 ^^^^^            ^^^  ^^^   ^^                   ^    ^^^^^  ^^^^^^^               
               ^^^ ^^^            ^^^^^^^^   ^^                 ^^^       ^^     ^^^^               
               ^^^ ^^^            ^^^ ^^^^  ^^^                 ^^^                ^^         ##    
               ^^^                ^^^ ^^   ^^^^ ^^^                                   ###    #####  
               ^^^                         ^ ^^^^^^    ^^^^^^                         # #    #####~ 
           ###                ^^           ^^  ^ ^^ ^^ ^^^^^^       ^^^             #####     ###   
           #~###              ^^               ^ ^  ^^^^^^^^        ^ ^             ## #     ####   
          ## ###             ^^^^^             ^^^  ^^   ^^^       ^^ ^^             ###     ###    
          #    #        ^    ^^^^^                   ^^^^^         ^^  ^^       ###   ###### ###    
          ######        ^^^   ^^^                    ^^^^^^^       ^^  *          ##### ######      
           ~######        ^^^^^                      ^^ ^^^^       ^ ^             ##~    ###       
            ##             ^^                         ^^^ ^^       ^^^                              
             ###           ^^                        ^^^^^^^^^                                      
              ##                                       ^^^^^^^                       ^^             
                                                       ^^*^^                         ^^             
            ~               ~                         ~##                            ^^             
          ###               #                         ~##                       *    ^              
          # ##              ###                ##     ~##                       ^^^^^^              
         ## ##               ##~               ##### ###      #                 ^^^^^               
         ####               #####              ## ~# #        #                  ^^ ^               
          ###               #####               #  ###        #                  ^^^^               
         ####                  ##               ######       ##   ^^^   ^^^      ^^                 
         ###                    ~    ^^           ~ ~###     #   ^^ ^^  ^ ^                         
          ###                        ^^^                    ##  ^^^ ^^    ^                         
          ###         ###              ^^^     ^^ ^         ##  ^ ^ ^    ^^                         
           ##         ###                ^  ^^^^^^^     ###  #^^^ ^^^    ^^                         
                      ###                ^^ ^^^^^       ######^^    ^^    ^                         
                 ^    #####               ^  ^^^^        #### ^^    ^^ ^^ ^^^                       
            ^^^  ^       ##             ^^^  ^^^^        #### ^^ ^^^^^^^^^^^^                       
            ^ ^  ^       #~             ^^             ####    ^^^^^^^^^^^^^                        
            ^^^^^^                      ^^     ##      #### ^^^^^ ^^  ^^                            
            ^^ ^^                       ^      #####   #### ^^^^^                                   
            ^  ^^                       ^^     ############ ^^                                      
            ^^^^^                      ^^^     ## ##   ##                                           
             ^^^^                      ^^^      ####                                                
               ^^                    ^^^       ####                                                 
                                     ^^        #                                                    
                                      ^^      ##                                                    
                                       ^^     ##                                                    
                                        ^      ##                                                   
                                     ^^^^   #####                                                   
                                     ^ ^^^^ ## ##                                                   
                                     ^^^^^^ ##                                                      
