                                                                                                    
                                                                                                    
                                                                                                    
                                                                                                    
                                                                                                    
                                                                                                    
                                                                                                    
                                                                                                    
                                                                                                    
                                                                                ^                   
              ^  ^ #   ^^  ^       ^  ^ ## #     ^^  #^      #    #  ## ^   ##^ ^                   
          ^^ ^    ^ #  #^ ^^  ^       ^  ^  ^     ^^ ^^     #   ^                 ^# #              
            ^   # ^        #  ^^ #^##  # ^#    ^ ^^^   #   #           #^  #    ^   ^#^^            
           #    #    ^   ^^  ^^#  ^        #^#^^           ^  ^       ^  #  ###^   *^               
             ^^ ^  ^ ^^  ^^  ^  ^        ^            ^       ^    ^ ^             ^   #            
          ^  #  ^        ^  ^    #   ^ ^^      ^ ^  # ^  ^      ^^   ^#~   #    ^^  ^   ^           
           ^^  ^ ^^ #    ^^^   ^     ^    ^     ~#^  #         ^      ^# #        ^^# ^             
           ^##            ^^    #  ^  # #  # ^#     ^^                 #        ^## ##              
            #  ^^         ^^^^ ^^         #   #^     ^^  ^ ^    #   #  ###^    ^^     ^  ^          
                ^  ## #    ^    ^ # ^    ^ #^ #^  ##  ^    ^  # ^  ^  ^  ^   ^  #^     # ^          
            ^^#        # ^         #^   #^ #~  ##     ^ ^^# #^      ^   ## #     ^    ^^            
                            ^^    #            #   ^ #  ^      ^ #  ^          ^^     #             
           ^    ##    ^      #  ^ #^#          *^# ^^  ##        #   #    # ^ #  ^  #               
                         ^^^#^# #             # ^    ^ ^ #   ^ ^#^                   ^              
            ^   #            ^^ #^ ^        #    ^    #         ^^#  ^^ #      ^^^^                 
            ^^#  ^^          ^^# ^   # #       ^ ^ ^   ^^ #   # ^ # ^       ^   ##  ##              
           #^   ^^ ^     ^ #      ^^^~ #    #   ### #               # #^    ^^    ^   ^  ^          
             #   ^ ^#       ^    ^  ^ #  ^^#~    ^                         ^^  ^      #^            
            #    ^       ^#    #^^^   #  ^   #        ^       #^^      #^^ #^    ^^   #  #          
            #  ^ ^     #      # ^#^       #  ^ ^   ^     ^     ^^   ^   # #    ^*#   ^              
               ^ *    ^^## ^^ #^^  ##   ^^^ ^ # ^^ ##^   ^  ^       ^  #   ^    ^   #               
         ^^    #    # #   ^  ^   #     # ^    #                    #   #~ #       ^     ^#          
                   ^# ^   ^ #  ^   ^##^           ^             #  #      ^   # #^^  ^# #           
          # #^ #    ^ #^# ^ ^^     # #^    #         ^   #       #^  #             ^ ^  ~^          
            ^ ^       ^^#  ^#  #        #   ^^ #     #^ ^ #  ^^   ^  #   ^ ^          ^             
          ^#  ^    #  ^ ^ #^  # #  ## #  ##  ^   #    ^ ^      # ^       ^  ^  #  ^ ^               
            #      ^^#  #  #  #     #^  ###~^                   #^     ^ #     # ^ ^^               
           ^^        ^   ^  ^  ^ ##   # #     ^^^^ ^  ^   ^     #  ^         #     #                
          ##         ^  ^^# # ^    #           #^  ^      ^# #     ^  ^    ^        ^#^^            
               ^   ^^^   ^  ^   #^#    ^ #^^    ^  #       ^          ^ #  ^  # ^#   ^  ^           
                 # # ^ ^^^  ^^       #         #   ^ ^     ^  ^   # ^^      ^            #          
          ^* ^         # ^ # ^ ## #         ^    #^^    ^  ^^  ^           #   # ^ ^#    #          
            #   #          ^      ^ ^^#^# ^^     ^  ^^  ^  #   ^    # ^ ~#  ##    ##^#              
          #          ^      ^  #  #         #     # #   #   # ^      #^ #     #  ^^  #   ^          
         ^^^   #   #  ^^   ^  # ^ #     #   ^    #   ^#    ^^^  #    ^^ ^^  ^ #   #^                
            ^    #      ^  ^    ^ ^   ^ ^      # ^^^ #   ^    #  ^    ^ #    #     ^                
          #^     #  ^    #   ^^^^ ^ # ^ ^ ^^   ^#    ####^  ^^ # ^ #    ^ ^ ^  #  #^ ^              
          #  ^^   ^^^^ ^^           #^^   ^ ^    #      #  #^   ^  ^    ^  ^   ##^  #   ^           
                 #     ^^     #      ^      #  ^^ #    ## ^##  #  ^  #     ^    #^      ^           
              # ^^   ^ ^  ^   #^ ^     ^      #   #   ^ #       #   # ^###  ^^     #   ^#           
             #  ^^^ #^^        #    ^        ^^ ^^ # #^    ^  ^       ^~   ^ # #       ^            
              ^  ^      #   ^##   ^  #  ^       ^          ##   ^#^# #    *  ^ #^#  ^^  #           
           ^# ^ ^#^^^ #            #^#  #    ^^^ ^       ^^^   ^##        ^^   ^^ # ^^  ^^          
           ^##  # ^^^# #   ^ #  #  #^^    #   ^    ^   #      ^#     ##     ~#^      #              
                  ^# ^      ^        ^  ^#   #    ##       ^    ^#      ^^#^ #     ## ^             
            #  ^     ^   #     ^^ ^        ^    #     ^   ^     ^^      #^ ^  ^# ^   #              
            ^  ^#      # #      ^^^#     #^^        # #   ^     *                 ^    #^           
             ^    ^  ^    ^#  #   #           #    #~## #^  #^    ^  ^#    ^  #       # ^           
          ^  #^#  ^    #  #        ^   ##  ^    #   ^    ^ #^^^  ^^  #  #^^     #  * #  ^           
              ^^  ^##   ^#^^      ^^      ^   ^    ^^#   ^  ^     ^     ~#  #   ^# ^^               
            ^^ # ^#  ^   ^   #  #  *^         *#  #^# ^^    *       ^ # ^~  # ##^      ^#           
              #     #  ^#^  ^^ ^    ^^# ^^^^   ^   ^  ^           ^ ^ # *  ^ ^ #   ^  ^^ ^          
             ^         ^  ##   ^      # #  ^  #    ^  ^     #     ##  ^  ^^    ^#                   
             ##^#  #            #       # #    ##        ^   ^  # ^ ^^^  ^ ^     #     ^ ^          
          #     ^        #  #^^       ##    ^  #   # ^# ^^ ^  ^   ^  ^^ ^    # #  #^^ #^            
               ^^    ###          # ^     #   ^# ^   ^ ^ # #   ^   #  ^#^^ #         ^              
               #       #  ^ #   ##  ^ #  # #     ^          ^      #  ^^^^^^  ##   ^^^ #            
            ##     ^  ^        ^^     ^^ #  *   ^^^^   ^^^# ^          ^^  ^     #   ^              
             ^#     ^   *^   #  ^ ^ ^   # ^ ^   ^ #  ^    ^^  ##^      ^^^             ^^           
                 ^      ^^      ^ ^ ^#   #        ^#^ # #^^#  ^^^      ^^^^^ ^     #                
           ^     ^ #   # #  ^        ^    # ^      # ^^   ^  ^^    ^         ^  ^^  ^    #          
                                  ^^    ^  #^ ##     ^^##   # ##   ^        ^ ^^    ^^   #          
             # ^^ #^#  ##   # ^   ^^          ^^  #       ^^     ^      #  ^^# ^^  ^^ ^  ~          
            ^^^^ #    ^  ^^  #     #  ^#       ^  #  #^  #    #^  #       #  #  ^^    ^^^           
             ^  ^#   #^              ^   ^ ###~# ^ ## ^    # ^^      ^^   #  ## #    ^#             
            ^^  ^ ^ ^  ^ ^           ^^  ^^^# ^  *^^ ^  ^     *  ^^ #^^  ^   ^ ^     ^              
                ^ ^^       ^    # #^  ^^  #^  ^^  #       ^        ^^^^^ ^     ^ #    ^ ~#          
             ^^ #^^        ^^   ^      ^  # ^^    ^  ^ #    #     #^^^^^   ^ ^    ^^    #           
              #         ##     ^^#  ^^    ^          ^##   ^      ^^  ^ # ^        ^^               
              ^## ^      #     #^^     #            ^^  #^   ^    ^^  ^^# ^   #  #  *^  ^           
               ^  ^   # # ^  ~#^^^      #  ^ #^^#^^ #   ^^^^     ^^^^^^^^     ### #  ^              
          # ^  ^    #    ^^   ^#          #      ##     # #     #^^^^    ~ *^#^     #               
            ^     #^^        ^^   ^    #      ^^      ##  ^  ^    ^^^ ^^##  ^     ^                 
                 ^     #^^^#  ^^^  #^   ^  ^         #^  #    #    ^  ^^#        ###   # ^          
               ^    ^# #^   ^^^# ^  ^    # ^        #          ^                      # #           
          ^^   ^  ^^   #^ ^  #^ ^   #  ^^^*   #   #^           ^       ^^ ^  ^# ^    ^              
            ^^      ~^ ^^ ##  #  ^^^  #  ^  #      ^^    ^ ^ #    #  # ^  #     ^^^    ^ ^          
             ^ #^^  # ^       ^^^  ^^         #  # ^^*   #        ^  ^   #^    ^#  ^  #  #          
                #     ^  ^           ##  #   ^           ^ ^  #  ###         ^#    ^                
              ^   # ^^   ^      #      #    #^             ^^^#    ### ^ ^   #^#^      ^^^          
              ^     ^                                                  ^ ^                          
                                                                                                    
                                                                                                    
                                                                                                    
                                                                                                    
                                                                                                    
                                                                                                    
                                                                                                    
                                                                                                    
                                                                                                    
