                                                  
             ^^                                   
             ^^^  ^                               
          ^^^^^^^^^                               
          ^^^^^                                   
          *^^^               ###~                 
         ^^^ *             ####                   
         ^^                 ###                   
         ^^                 ~##                   
                  ~###       ~                    
                  ####    ^^^^                    
                  ####       ^                    
                  ##        ^^                    
                            ^^                    
                             ^*                   
                             ^^                   
                         ^^^ ^^                   
                      ^^^^ ^ ^                    
                      ^  ^^^^^         ^^^        
         ^^              ^^^^          ^^^^^      
     ^^^^*^                             ^^^^      
        ^^^                  ^^^     ^^^^^        
                             ^ ^^^      *         
                          ^^^^^^^^                
                        ^^^    ^^                 
                      ^^^^      ^^^^              
                      ^^^^      ^^ ^^             
                    ^^^^^      ~ ##^^             
                    ^^^        ###~^^             
                ## ^^          ### *^^^^          
                 #             ~     ^^^  ##      
                 ###                   ^  ##      
               ^   ###                   ###      
       ^^^^    ^^                        ####     
       ^^^^^^^  ^                        ####     
     ^^^^^ ^^^^^^                         ~##     
     ^^^^^^^^^^                                   
       *^^^^^ ^                                   
        ^^^^^^^                                   
                         ~                        
                        ##                        
                       ~###                       
                          *    ^^                 
                          ^   *^^^                
                          ^ ^^^^^^^^^^*           
                          ^^^ ^^^^^               
                          ^^  ^^                  
                                                  
                                                  
                                                  
