                                                                                                    
                                                                                                    
                                                                                                    
                                                                                                    
                                                                                                    
                                                                                                    
                                                                                                    
                                                                                                    
                                                                                                    
                                                                                                    
          # #             # ###       ## #                  #           #             #             
                         # ##   #          #                                       #                
           #      # ## #                           #                     ## # # #                   
                ##                   # #                   #             #          #               
             #         #        # #  #                 #  #    #          #        #                
                  #    #  #       #   #            ##         #             #  #    ##   #          
                       #                 #            #        #  #                                 
          #   #    #       # #          #         #   ~## #           ##  #    ##                   
                          ##                  #        # ~#     #   #      #   ##                   
             #      ## # *# #    #### *   *      # # #       #   #                  # #             
           #            ^^^  #     # ^^^^^^   #     #     #             #       #      ###          
          #      #     ^^ ^^^      # ^^^^ ^^^         #      #       #         #   #   #            
              #     ## #  ^^           ^^##^^*   #    ##     #      ~#             #   # #          
          #   ## #        #  # #        ## ^^^         #         #                 ##               
            #  #    #  ##              #   ^^^^^       #~ ~    #          #     #      #            
               #   #        #         #      ^^^#       # #        #                                
                  #                    #       ^        #       #    #                              
                  #         #        #  #  #   ^           #   #   #       ##                       
                       #       #             #     #         #  #  #     #     #                    
           #  #   #       #  ##     #          #  # #    #             #       #  #   #             
           #        #       # #       #  ##  ###        #  #          #        #                    
           #~      #   #    #         #     ##     #     #                     #    #               
                ##       #                                #    # #  #                               
           ##    #     #     #  #   # #      #    ###           #                # #* ^#            
           ##      # #  #   ~#      #    #   #                 #     #  # # #      ^^^^             
            # #  #   #       #             ###             ##    ##  ##          ^^^     #          
           # # ##       #       #      #         #  #    #  #   #       ^^^^#   #^^^                
          #       #   #  #        #      #  #  #         ~      #      #^^^^^^   *#^                
            #        #        #*            ~      ##      #       #    ^^^^^^^^^^^^                
               #               ^ #^^## ## # #      #      #   #     #   ^^^^^^^^^                   
           #     #             ^^^^^                          #  #   #       ^^^^ #  #              
          ##       ##        #    ^^#             #      #                   ^^       #             
              ##            ## ^^^^     #    #       ##      #   # # * ##    *    #   #             
          #   #          #   ^^^^^ #        #     # #          # #^^^^  #              #            
               #        #    ^ #    #  #         #                ^^^^              #   #           
            #   ##  #     #     #       #   ~            #        ^^^^    #   #                     
                #     #   #                ##   #     #   # # ###  ^^*           #  ###             
                   #                      #     ###            ##                                   
                 # #  #   #   # ##     #    ##~ #      #     #          #                           
           #     #                  #     #    ~#       # #   #          ## #                       
             # #     #               #   #       #     #      # #       #          #    #           
                   #           #                       #      #    #   # #  ##  #      #            
             #                 #                #    ##~         #  ##    #            #            
           # #          #       #      #     ##      # #        #                      ##           
          #     #             # ##    # #  #         ### #   #    # #      #                        
                               #    #         #    ##           #  #      #         # #             
         ~# #     #  #              ##     #  # ##             ##      # #~#          #             
          ~       #    #       #     #   ^^#       # ~#  # #   #              # #                   
           ##      #   #  #   #      ^^^*^^^           ###       #        # #         #  #          
             ##                   #  ^^^^^ ##      #  ^^^^   ##   ^^^^            #   #  #          
          ##          ##            # ^     #           #^      ^^^^^^ #     #  #       #           
             #         #    #         ^^ #           # #^^   ^^^^^^^^^    ##  #                     
              #  # #               # # ^        #       ^    ^^# ^^^^^     #   #         #          
          #                  #      #^^^           ##  ^^^^^**^*#^^^    #~      #    #              
              #    #       #         ^^    #  # #    ##^^^ ^^^^ #    # #              #             
                       #        #  # ^^    #    #   # #     ^^         # # ^^*  #                   
           #          #      ^^ ## ^^^       #    #          #           # ^^^^                     
          #   # ## #         ^^^^^^^           ##  #     #  #     #       ^^  ^                     
           #            # # #^^^^^^ #      ##  #    #   #  ## #     #   # ^# #^*      ##            
                  ##          ^^^^^## #            #     ##       #  ^^ ^^^^^^^ #                   
              #  #    #       ^^^  ##    #      #  # # # #    # ##    ^^^ ^^#    #              ^^^^
                     #~ #     ^^^    # ##                   #            ^^          ^^^ ^^*    ^^*^
          #            #      ^^^    #     #  #           # #  #         ^   ##      ^^^ ^^^    ^^^^
          ## #                ^^#  # #                 #      ##   # #  ^^#           ^^^^^^^^^^^^^*
              #              #        #      #   # #                ##  ^^^^  #      #^ ^^^ *^^^^   
                    #       #                                      # #  ^^^^        #          ^^   
                             #     #  ##  #     #      #     #   #      ^^^^                        
          # ##         #   #  #      # #              #   #  #   #         #                        
          # #  #        # #    ##       #         #             # #  #  # #   #     ##  #           
            ###       #  ##           ##     #   #                  # #   #     #                   
                  #   ~    # #  #           ##   ##  ##   #          #         ##  #                
                       #    #        #          #    #     # #   #             #      #             
               #               #   # ##       #                #                                    
                                 ### #    #  ##           #   #                                     
            #  #   #           # #     #    #                                    #  #               
           #          #                 # #      #                 #        #                       
             ### #             #        ##      ##          #   #             #          #          
                            #            #    #        #   #    ##                                  
                         # #    #            #   #                        #   #  #  # ##            
               #               #    #      #  # ##  #   # #      #  #     ##      #                 
                                                                                                    
                                                                                                    
                                                                                                    
                                                                                                    
                                                                                                    
                                                                                                    
                                                                                                    
                                                                                                    
                                                                                                    
                                                                                                    
