                                                                                                    
                                                                                                    
                                                                                                    
                                                                                                    
                                                                                                    
                                                                                                    
                                                                                                    
                                                                                                    
                                                                                                    
     ###~                                                               ~                           
     #### #                                                            ##                           
   ~  #~###                                                            ##                           
  #####   ~                                                            ##                           
  #####                   ^^^                                          ##                           
  #####                    ^^                                           ~                           
                           ^^^                                                                      
                             ^^                                                                     
                              ^                                                                     
                              ^              ^^                                                     
                              ^^        ^^^ ^^^^^                                                   
     ^^                        ^     * ^^^^ ^^^^^^                            ^                     
     ^^^^^           ^^    ^^^ ^^^ ^^^^^ ^^^^^ ^^^^ ^^^      ###              ^                     
     ^^^^^^^^^^      ^^^^^^^ ^^^ ^ ^^^   ^^^^^  ^^^ ^^^      # ####          ^^                     
      ^^  ^^^^^   ^^ ^^^^      ^^^  ^^               ^^     ## ####          ^^                     
        ^^^^^^^^  ^^^^^         ^^                 ^^^^^    ##  ##~          ^^                     
        ^^^^^^^^^^^^*                ##                ^     ## ##    ##     ^^                     
          ^^^ ^  ^^^                 ##               ^^      # ##    ##                            
            ^^^                     #####             ^^      ##########                            
                                    # ##          ^^   ^         #######                            
                          ##       ####           ^^^ ^^         #####                              
                          ###      ####          ^^*^ ^                                             
                       #### #       #####        ^^ ^^^                                             
                       ##   ###        ##         ^^^^     ^^                        ^^^            
                       ##  ####     ####   ~        ^^^  ^^^^           ^^^^^^       ^^^            
                       ### ##       ###  ####       ^^^  ^^^            ^^^ ^^       ^^*            
                         #           #####  #       ^^*^^^            ^^^^^ ^^^      *^^            
                         #           ###  ###          ^^   ^^        ^^    ^^^                     
                         ###            ###             ^^ ^^^       ^^^^   ^^^                     
                      ~#####           ~#            ^^ ^^ ^^^       ^^^^     * ^^                  
                       ####          # ##            ^^ ^^^^^^^^    ^^^^      ^^^*                  
                                     # ##            ^^^^^^^^^ ^    ^^^^      ^ ^                   
                                 ^^ ##  #            ^^ ^^^^^^^^              ^^^                   
            ###     ^^          ^^^ ######           ^^ ^                             ^^            
            # ###   ^^          ^^^    ###           ^^^^                             ^^            
            ###### ^^  ^^^^^^^ ^^^       ~           ^^                              ^^             
              ## # ^   ^ ^^  ^ ^^^^                                                  ^^^            
              ####^^   ^^^^^^^ ^^^^      ##~                                         ^^^            
              ####^^    ^^^^    *^^      ##                                          *              
                 # ^^  ^^^              #####        ^^    ^^                                       
                ##  ^^ ^                ## ##        ^^^^  ^^                                       
               ##    ^^^                ##         ^^^^ ^^^^^                                       
               ##                       ##         ^^^^                                             
     ^^^^^^    ##                 ^                ^^^                        ^^^                   
     ^^ ^^^                       ^^^           *^^^                          ^^^                   
      ^^^^^^^      ^^               ^       *    ^^*                          ^^^                   
       ^ ^^^^     ^^^               ^^*  ^^^^     ^^^                  ^^^    ^ ^^^                 
       ^^^^^^   ^^^^^                ^^^ ^^^^     *^^                  ^^^*   ^^^ ^^                
          ^^    ^^^^                   ^^^^^^      ^^                  ^^^^^  ^^^^^^                
          ^^    ^^^^                                ^^                 ^^^^^  ^^^^^^                
          ^^    ^^^^                                                   ^^^    ^^                    
                                                ^^ ^^                   ^^^*  ^                     
                                                ^^ ^^     ^^            ^^^  ^^^^                   
                                                ^^^^^^^^ ^^^                 ^^^^                   
                                                ^^  ^^ ^^^^^                   ^^                   
          ^^                                                                   ^^                   
          ^^  #########                     ^^^                      ^^                             
         ^^  ## ## ####    ^ ^^             ^^^                      ^^^                            
      ^^^^^  #     ####~   ^^^^             ^^^                      ^^^                            
      ^ ^ ^  ####  ##     ^^^^^^^^            ^^                     ^^                             
      ^ ^^^     ## ####   ^^^^ ^^^                                  ^^^^                            
     ^^          ### ~###   ^^ ^^^^^^                               ^^^^                            
      *                 ##        ^^^           ^^    ^^^^^^^^^^^^^^^                               
                        ##        ^^^           ^^^^  ^^^  ^^^^^ ^^                ^^^^             
                        ###        ^^            ^^^^ ^    ^^^^^                   ^^^^^^           
                        ##~        ^^            ^^ ^^^^^   ^^                    ^^^^ ^^      *    
                        ~          ^^                  ^^^^^^^^                   ^^^^^^^      ^^   
                                   ^^                  ^^^^   ^                   ^^^^^^^ ^^   ^^^^^
                                    ^^                 ^^     ^^                      ^  ^^^^^^^^^^^
                                     ^^          ##    ^^     ^^                      ^^^^^^^  ^^ ^^
                                      ^^^^       ##   ^^^     ^                         ^^^^^  ^  ^^
                                      ^^^^        #  ^^^ ^^^^^^                                ^^^^^
                                      ^^^^           ^ ^ ^^^                                      ^^
                                                     ^^^   ^^^                                      
                 ^^      ^^                           ^^  ^ ^^            ##                        
            ##~  ^^^     ^^^                              ^^^         ######                        
            ##   ^*^^    ^^^^                                    ### ####~ #                        
            ###  ^^^^  ^^^^ ^                                    # # ####  ##                       
           ##     ^^^  ^^^^ ^^                                   # # ##     ##                      
           #      ^^^   ^^                                         ###      ##                      
          ##      ^^^   ^^                                                  ##                      
          ####          ^^                                                  ~##                     
             ##                                                            ## #                     
           ## #                                                          #### #                     
           ####                                                          ######~                    
           ###                                                           ###                        
           ####                                                                                     
            ###                                                                                     
                                                                                                    
                                                                                                    
                                                                                                    
