                                                                                                    
                                                                                                    
                                                                                                    
                                                                                                    
                                                                                                    
                                                                                                    
                                                                                                    
                                                                                                    
                                                                   ^                                
                                                                  ^^                                
                # #   ^ ^ ^ # #         #       ^   # #   # ^ ^^^^^        ^^^  #   #   #           
           #^               ^   ^  #        #        ^      ^  ^ ^^   ^  ^      ^# ^^               
          ^#       # #         ^              ^#     ^   #      ^   #  ^   ^^^  ^^^ #^^#            
                   #~#    #  #^            #    ##  ^ #  ^            ^ ^  # ^^  ^   ^  #           
          ^        ##~   #  #              ^^   ^^   #  *  ^     ^     ^ #       ^#                 
                ^^ ^^#^# ^^   #    #         ^  ^^ ## ^#^       ^   #    ^ #     ^                  
          ##             ^   ^    ^  ^#    ^     ^      ^     ^     ^          ^    # ##^           
                #   ##        ^       #^^    ^   #^    ##     #  # ^  ^ ^^  #         # *^          
           #^  ^#^   ^   ^ # # ^#~     ^     ^ ^ #^ ^   ^  ^ ^##         ^  ^^#          #          
           #  ^^^      ^^*             #~# ^ #       #   #     ^^# #     #   ^^   ^ #   ^#          
           #~ ^     #^ ^##  #^^   ^    ## ^      ## ^  ^#      #    ^^ # ^   #^      ^   ^          
          #^^    ^ #   ##  #^^    #          #    # ^# ^#       ##^^ # ^ ^^  ^        #             
           #  #                   ^ ^# ^ ^^ #  #     #^       ^^^*^^      ^    ^^#  #^~             
              ^ ^      #   ^       # ^  ^## ^  #        ^ ^   ^ ^^ ^#   # ^    ^ #  #^              
            #^#  #    ^    ^^ ^^     ^ ^     ^^         ^  ^  ^^^^^^    ^ ^       #  ^              
          ^   #  #  #^ ^  ^ ^ #^       ^ ^^           ^   ^^  ^^^ ^^   #     #   ^#     ^           
          ^      #^ ^  ^# ^#^       ^     #   ^^        #     ^^  #^        #^    ^  #              
                 ^ # #^   ^ ^^ ^^   ^^#^^^ #  #    ^^  #^^ ^    #^^        #^^^#     ^              
           #         ^    ^^      #                   ^          ^     ^^    #   #  #  ^            
           ^^  ^        ^# #^^       #   ^      #^    #            ^  ^           ^      #          
            ^ ^^   # ^  ^  ^       ^#  ##^ #     ^ ^ #    ^^^^ #  #  # # # #       #  # ^^          
                ##      #  ^             ^^^ ^^       ^      ^                ^     ##   ^          
          #  ^ #   #       ##  #  ^ # ^^^^^  ^^  ^ #      # ^  #  #    ^     ^  #^*#  ^  ^          
           ^^^  ^       ^^ #  ^ ^   ^ #  ^            #  ^ #  ^^       ^ #^ ^^^  ^                  
             ^  * ###^ ## ^   ^  #  ##  ^^#  ^ ^^ ##     ^         ^  ^ #           #               
              ^^     ^#   ^    ^   ^ ^^  # #^  # ^^   #    ^ ##^ ^^^  ^^   ##  ^    ^               
                         ~## ^ #  ^      ^  ^^ #       #  #^  #^ ^    ##      ^   #      #          
              #^       *^ ^^^^ ^^      # ^ ^ ^ #    #   ^  #   #    ^^ #      ^##^       #          
             ^ ^ ^^# ^#^^       ^^ ^^      #^    #     ^^ #^# #   ##  ^   ##^                       
                    ^^^^^     #  # ^    #      ^   ^^     ##   ^  #^        ^#^    # ^^             
          #    ^^     # ^            ^#   ^       #^^#   #      ^  #  # #    #        ^             
           # ^  ^   ^   ^#     ^ #  ^^      ^#   ^^^#  ^   ^^   ^          #^^^   # #               
          ^^^   #^^^    ^     ^       # #  ^     ^^ ## ^   ^^  ^#         ^ ^ ##        ^^ ^^       
             #   ^ ^       ^      ^##   ^^    #    #^ ^   #^  #^             ^##  #      ^ ^^       
          #  ^  # ^  ~##  ^  #~# #^ #   ^   ^^ #   #^  ^ ^^^    ^      ^ ^    #  ^^^     ^^^^       
          ^ ^        ^# ^   ###^#           ^^ #~     ^ #^ ^      ^    ^# ^      #    #   ^^^^^^    
          ^#^ #   #        ^ ##           ^^   ^##  ^^  ^ ^   #  ^     #    ^         ^#   ^   ^    
          ^# ^# #   ##   ^ # #      #           ~      #^#           #      ^ ^      ##    ^^^      
          ^  ^#    #      ^      #   ^   ## ^^^   ^      ^   #     #   #      #^   ^ ##    ^^^      
          *^    #   ^ ##^^^  ^#  ^#   #       ^ ^#  ^#   ~  ^     ^#   # #     ^#  ^^#   ^^^^^      
           #       #  ^ #  ^   ^^  ^# ^^   #  ^  ^#  # ^ ## ^^^            #    # # ^ #  ^          
          ^        ^  ^       ^           ^  ^ ^   #  #    ^          ^^^       #    ^^^^^          
            #^   ^##           #          ^     ^^      #^^^        ^         #^^     ^^            
                  #        #^   ^   ^#       ^ #^ ^^ ^    ^^   ^# ^^ ^     #   ^#   ^  ^            
              #^^    # ^   #   #       ## # # ^^##^^       ^   ^    ^^    #    ^   #   # #          
            ^ ^#    #^ ^     ^    ^^^   #  #^ ^^^ ^      #  # #^^^ #^    # ^   ^  ^^# ^  #          
           ^            ##^^^^^        #    ^  ^  ^^     ^  #    ^     #   ##  ^     #  ^#          
             #        ^    #^ ^   ^         #  #    ^           #^^   ^ # ^    ^ ^ #    #           
          # ^  ^   ^ #^^ # ^^^^          ^ ^^#     ^^            *          #            #          
           ^^          ^           #^ #  ^#^    #   ^#   ^#   ^^        *^^    #                    
          ^ ^     #       #    # ^      # ^    #       # ^        ^   ^     ^#   ^   ^ ^ ^          
            ^   ^^   ^ ^ ^               # ^     #  ^   ^   ^^   ^##    # #   #      ## ^^          
               # # * ^^  #     ^^   ^   ^    #^         ^  ^^^  ^ ^   ^ #          ^ # ^#           
          ^^  # ^^^^     ^^      ##     ^ #    #^           #^###   ^#  ^^ ^  ^ # ^                 
               ^ #^ #     ^ ^   #     ^       ^   #~           ^         ^#       ^ ^   ^           
          ^     #^^ ^      #          ^##    ^ ^  ^  ^ #     # ^      ^ ^^       ^#^##   ^          
             #  #   # ^  ^ ^#~ #           ^ ^ ^^##  ^#      #  #    ^  ^      ^#^       #          
                #     # ^ # ^* ^^  ^       ^ ^  ^        ^^^  #  # ^^^ #  ^    ^^ #  ^##            
                  #        # ^ ^#^^  ~   # ##  #    ^      ^   #   # ^     ^ ~#     ^^~  ^^         
            #     #       #    *^  ^## # #^   #      #*^    ^ #   ^     ^  #  #    ^                
           ^ ^^^^^  #   ^      ^^ ^^ #    #   #     ^ ^    #^^^^^^^^ #^ ^  ^^        ^^             
           #   #     ^      #  ^ ^^ ^   ^^    ^ ^ ^^^^^   ^^#      ## ^  ^# ^    ##                 
          ^  ^  ^ # ^^    ^## ^ ^  ^   ## ^ #^  ^^            *    ^   ^    *      ^                
           #^       ^ ^   ^ # # #  ^   #  ^       #   #  ^    ^        ^      #   ^^   ^ ^          
             ^   ^    ^ ^^^^# ^  ##   #^#   #  ^       ^      ##  ^^   #  ^^  ^   ^      #          
           ##^   #     # # ^ ^#  ^^^      ^   ^    #    ^^ ^  #  ^    ~#^ ^  # ^^ *  ^# ##          
                        #  ^ ^     ^      ^ #^     ^^     ^^    #     # #  ^  ^^     ^  ^^          
          #      ##^^         ^    ^      ^^#        ^ #  ^# ^    ^   ^^#    ## ^        #          
          ^            ^              # ^ #          ^#   #   #     # ^^#^    ^        ^            
             ^^  ^^  # ^ # ^ #          ^  ^       ^ #  ^ ^^   ^ ^   ^#^            ^^ ^^^          
          # #        #  ^           ^ # ^ ^^   ^^^^##         ^^^^ ^^ #^^#    #          #~         
             ## ^#   #^^^^##    ^  #    ^^      ##  *^## #   #       ^  ^^     ^                    
             ^           ^     ^           ^# ^    #           ^*    #     ^         ^   #          
             ^ ^  ^#       ##^ ^ #   #      ^#^ ^      # #   # #^  #       ^^^      ^^^#            
          ^   ^^# ^      ^^         ^   #^ #    ^#       ^^  #     # ^^        ^^ ^ ##*^            
              #     ^        ##^^   #           #       ^     # ^^   ^^^^^# #   ^ ^# # ^##          
            #    ^    ^  ^   #    #   ^    ###  #       ^  #   ^^#   #^# ^^^          #             
            #     ^^   # ^# ^^      ##^^^   #^^    ^   #      ^^    #  # ^ ^     # #^ # ^#~         
          #^ ^^  #  #   ^ ^  ^   ^^           #       ## ^#^     ^   ^   ^^^     # ^^^              
          ^^^# # ^        ^#  # # ^   #^  #^              ^^ ^ ^  ^  ^      ^^ ^^     ^             
            ^    ^                                             ^                                    
                                                                                                    
                                                                                                    
                                                                                                    
                                                                                                    
                                                                                                    
                                                                                                    
                                                                                                    
                                                                                                    
                                                                                                    
