                 ^^^                                                                                
                ^^ ^^                                                                               
                ^^^^^^                                                                              
                   ^^^^^                                                                            
                    ^^^^                                                                            
                     ^^^                                  ^^                                        
                     ^^^^*                                ^^                                        
                      *^^                               ^^^^^                                       
                       ^                                ^^ ^^                                       
                       ^^                                ^^^^^^                                     
             ^^       ^^^                                   ^^^                                     
             ^^^^^^^^^^                                      ^^                                     
            ^^    ^^                                     ^^  ^                                      
            ^                                            ^^^^^                                      
                       ^^^^  ^^                          ^^^^                          ^^^          
                ^^^^   ^^^^ ^^^                            ^^                           ^^          
                ^^ ^^  ^^^^^^^^                     ^^^^^^^^                            ^^   ^^     
                 ^  ^^^^   ^^^ ##                ^  ^  ^^                                ^^ ^^^^^   
                 ^   *     ^^ ###                ^^^^^                                    ^^^^^^^   
                              ###                  ^^^                                    ^^^^  ^   
                             ####                                                 ^       ^^^^^^^   
                            ######         ^^^                                    ^^       ^ ^^^    
                            # ####         ^ ^^^                             ^^   ^^       ^^^ ^^*  
                            #####       ^^ ^^^^^                            ^^^  ^^            ^^   
                            ##~##       ^^^^^^                              ^^^^^^^        ^^^^^^^^ 
                           ##           ^^^  ^^                               ^^^^^        ^  ^^^ ^^
                           ##                ^^                                ^^^              ^^^^
                           ##               ^^                                 ^^^                ^^
                           ##               ^                                                       
                           ##             ^^^                        ^^^                            
                                          ^                        *^^ ^^                           
                                          ^                            ^^                           
                                                                   ^^^^^^^           *              
                                                                   ^^^^^^^           ^^^^           
                       ^^                       ^^^                ^ ^^ ^^           ^^^^           
                       ^^^^^^                  ^^*^     ~~        ^^ ^^^^    ^^    ^^^^^^           
                   ^^ ^^^^^^^^                 ^* ^^   ####       ^ ^^       ^^     ^^              
                   ^^^^   ^^ ^^              ^^^^^^^   ####       ^^^^^      ^^^    ^^              
                  ^^ ^^     ^^^             ^^ ^^^^^   #####      ^^  ^^     ^^^^^                  
                  ^         ^^              ^  ^^^      ####           ^ ^^   ^^^^                  
                  ^         ^^             ^^         #####^^^         ^^^^   ^^^^                  
                ^^^                                   ~##  ^^^            ^^^ ^^^                   
                ^                                      ^~ ^^^^              ^^^^^^                  
            ^^^^^                            #      ^^^^    *                  ^^^                  
            ^^^                              ##     ^ ^^                                            
            ^^                                #     ^^^^^    ^^                                     
             ^                               ##       ^^^   ^^^                ##                   
             ^^                             ~#                ^                ####                 
      ^^      ^^ ^^^                         ##               ^^           ~   ## #                 
   ^^ ^^       ^^^^^                         ##               ^^^^         ########     ^^          
   ^^^^^^         ^^                        ##               *^^^^  ^       ##   ##     ^^          
  ^^^^^^^          ^^        ^^^^        ## #                   ^^^^^             #    ^^^^         
  ^^^^^^            ^        ^  ^        ####                     ^                    ^^ ^         
       ^      ^^           ^^^  ^^^      ##                       ^                     ^^^*        
  ^^*^^^   ^^^^^           ^^     ^      ##  ###                 ^^                    ^^^^^^       
 ^^^^^   ^^^  ^^            ^^    ^^^^   #  ## #        ^^       ^                   ^^^   ^^       
^^       ^^^  ^             ^^^    ^^    #######       *^^^^^^  ^^                   ^     ^        
^^^^^^   ^                  ^^^     #        #          ^ ^^ ^  ^                   ^^^^^^^^        
^^ ^^^^^^^                  ^^      #~      ~##      ^^^^    ^^^^                  ^^ ^ ^^          
   ^^  ^^                           ####   ####      ^^        ^^                ^^^  ^^^^          
                               #     ###   ####   ^^^^^                          ^^   ^^            
                               #     ###~     ####^^                     ^^^     ^^^^^^             
                               # ##            ~ # ^^                   ^^ ^       ^                
                               ####                 ^^^                ^^  ^^      ^                
                      ^^        ####                 ^^                ^^^^^^     ^^                
                      ^^           #####             ^^                ^^ ^^      ^                 
                    ^^^^           ## ##              ^^               ^^         ^                 
                    ^^^^              #               ^^              ^^^                           
                    ^^^               ###             ^               ^^^^     *                    
                    ^^^                ##             ^^^            ^^^ ^^ ^^^^ ^^^ ^              
                     ###         ^   ###               ^^            ^^^  ^^^  ^^^ ^^^              
                     ###        *^^  #                 ^^             ^^       *                    
                   #######      ^ ^  #                  ^^                                          
                   # ##  #      ^^^ ##                   ^                                          
                   ###   ##     *^^~####                                                            
                   ~ #    #~       #####                                                            
                    ##    #####    ####                                                             
                    ##     ####    ##                 ^^^                                           
                     #     ####     ^^                 ^^^^                                         
                  ## ##             ^^^                ^ ^^           ^^                            
                  #####            *^^^                ^^^            ^^                            
                                     ^^                           ^^^*^^                            
                                     ^                         ^^^^ ^^^                             
       ##   ##~                                                ^^^^                                 
   ~##~########~                                          ## ~ ^^^^                ^ ^^^            
###### #  #####                         ###               #####                    ^^^^^*           
### ####  ######                        ##               #########                    ^^^           
#######~       ##                                        #########                    ^^^           
  ##                                                     ##    ##                     ^^^           
  ##                                            ##  ######                            ^^^           
                                             ########## ##                                          
                                            #########                                               
                                            #######                                                 
                                              ## ##                                                 
                                              ##                                                    
                                                                                                    
                                                                                                    
                                                                                                    
                                                                                                    
                                                                                                    
