                                                                                                    
                                                                                                    
                                                                                                    
                                                                                                    
                                                                                                    
                                                                                                    
                                                                                                    
                                                                                                    
                                                                                               ##   
                       ^^                                                                  ### #####
                       ^^                       ^^^                                        #########
                       ^^         ^^^        ^^ ^*^^^  ^^^                                  ## ## ##
                       ^^         ^ ^        ^^^^   ^^^^ ^                                   ##     
                      ^^         ^^ ^                 ^^^^                                    ##    
                      ^^^^^      ^^^^             ### ^^^^^^                              ######    
                      ^^^^^^^  ^^^^^              ### ^^^^ ^                           ######       
                       ^^   ^^^^^^^^              ### ^^^^^^                           ########     
                      ^^^*    ^^^^^^ ##            ##      *        ^^^^                ##### ##    
          ^^^         ^^             ## #       ####                ^^^                     # ##    
          ^ ^^^        ^^^           ####       ######              ^                       ###     
          ^  ^^                      ####         ####             ^^           ^^^                 
          ^^^^^^^                       ##~      ###               ^           ^^^^                 
           ^^  ^^                                ###               ^       ^^  ^^^^                 
           ^                                                     ^^^  ^^^ ^^^^^^^^^                 
          ^^     ##~                    ^^^        *^^^^^        ^^^^^^^^ ^                         
          ^^^^    ##                    ^^^         ^ ^^^              ^^^^                   ^^^^  
            ^^     #                 ^^^^           ^^^ ^^                                    ^  ^  
            ^      ~                *^^^^         ^^^^^ ^^                                   ^^  ^^^
            ^^                       ^^          ^^^^^^^^           ^^*                      ^^^^^^^
             ^   ^^^^^                               ^^             ^^^^^^   ^^           ^^^^^^^^^^
             ^^ ^^^^^^ ^^                            ^^             ^^^ *^^  ^^           ^^^^^^^^^^
              ^^^   ^^ ^^^^^                                         ^^   ^^^^^            ^^^      
              *^^    ^^^^^ ^^                                         ^^^   ^^^          ^^^^^      
                         ^^^^                                         ^^^^^ ^^^^       ^^^^         
                         ^^^^                                        ^^^^^^^^^ ^^      ^^^^         
                         ^^^^                   ^^                  ^^  ^^^^^^^^^     ^^^^^         
                        ^^ ^^               ^   ^^  ^^              ^^  ^^^^^^^^      ^^^^^         
          ###           ^   ^      ^^^^     ^   ^^  ^^^        ^^    ^ ^^^^^ ^^^         ^^         
          # ##         ^^^^^^      ^^^^^^^  ^^^^^^  ^^^        ^^^^  ^^^^^^^^^                      
             ##        ^^^          ^^^^ ^^^^^^^^^  ^^^       ^^  ^^  ^^   ^^                       
             ##                    ^^^^^ ^^   ^^^^ ^^         ^^^^^^                                
             #   ^^                ^ ^           ^            ^^ ^^^^^                              
             ##  ^^^               ^^^           ^^              ^   ^^                             
              #  ^^^                            ^^^              ^^^  ^         ##~                 
              #   ^^^                           ^^^            ~   ^^^           #                  
            ~##   ^^^^ ^^^^                    ^^           ####     ^^       ####                  
             #     ^^^ ^^^^                    ^^          ~###      *^       ### *                 
            ~#    ^^   ^^                       ^           #         ^       ### ^^                
            ##    ^                            ^^           ##      ^^^           ^^^               
            ##    ^^^   ^^ ^^^^^^             ^^             ###    ^^^         ^^^^^               
        ^^^ ##      ^^  ^*    ^^^             ^^            ######   ^^         ^^ ^^          ^^^^ 
        ^^^         *   ^     ^^^                           ######   ^^          ^^ ^^*        ^^ ^^
         ^^             ^^^                                 ~## ~     ^^^         ^^^^          ^ ^^
         ^^             * ^^^^                               ##                   ^^^          ^^^^^
          ^^     ^^^      *^^^                                        ^^^         ^^^^       ^^^ ^^^
          ^^     ^^^       ^^^                                        ^^^          ^^^       ^      
          ^*     ^^                                                   ^^^^^     ^^^^^^      ^^      
          ^^^    *^                                                ^^^^^^^^   ^^^^^         ^       
           ^^*                                                     ^  ^^    ^^^^           ^^       
                                                                 ^^^  ^^^^  ^^^^           ^        
                                              ^^                 ^^^^^^^^^ ^^          ^^^^^        
                                              ^^^                ^^  ^^^^^ ^          ^^^^^^        
                                              ^^                                      ^^^^^^        
                                               ^^  ^^                                 ^^ ^^         
                                ##~      ^^    ^^  ^^                                 ^^^^^         
                                #####    ^^^^  ^^^^^^^                                   ^^         
                                ### #    ^^^^  ^^ ^^^^                                              
                                ## ##        ~### ^^^                                               
                                 ###~         ### ^^^                                               
                                   ### #####  ##~                                                   
              ^^                     ####  #                                                        
          ^^^^^^                     ~######                          ^^^                           
          ^^^^^^   ###                 #####                          ^ ^^^                         
          ^^ ^^  ### ##           #### ~                              ^^^^^                         
          ^^ ^   ##   ####        # ##                                 ^^^^                         
            ^^    ##  ####    ########                               ^^^                            
           ^^         ####    ########                               ^                              
           ^^         ##      ##### ##                              ^^                              
                               ####                           ^^   ^^                               
       ^^^^^^ ^     ###        ##                             ^^^^^^                                
       ^^^^^^^^     ###                                       ^^  ^^                                
      ^^^^^^* *     ###                                       ^^                                    
      ^^^^^^        ##                                        ^                                     
      ^^^^^^  ########                                        ^^                                    
        ^^^^######                                             ^                                    
            ####                                               ^^                                   
            ###                                           ^^ ^^^^                 ###               
            #######                                    ^^ ^^ ^^^              ~#### #               
            ####  ##                                   ^^ ^^^^^^               ##~ ##               
            ##     ###                                ^^^^^^^                   ##~###              
                ######~                               ^ ^^^^^                    ### #              
                #   ##                                ^ ^                           ##              
              # #                                     ^^^                           #               
              ###                                                                ####               
                                                                                 ####               
                                                                                 ##                 
                                                                                                    
                                                                                                    
                                                                                                    
                                                                                                    
