                                                                                                    
                                                                                                    
                                                                                                    
                                                                                                    
                                      *                                                             
                                    ^^^                                                             
                                 ^^^^ ^                                                             
                                 ^^^  ^                                                             
                               ^^^^^ ^^                          ^^^^^                              
                               ^ ^^^ ^                          ^^^^^^                              
                               ^^^^^^^              ^^          ^   ^^^                             
                               ^^^^                ^^^          ^^^^  ^                             
                             ^^^                   ^^^  ~         ^^  ^^^                           
                              ^^                   ^^   #         ^^^^^^^                           
            ^^^                                  ^^^    #     #### ^^^^^^                         ##
            ^                                    ^^^   ##     #### ^^^^                           ##
            ^                                    ^^^^  #       ##                                ###
        ^^^^^                    ^^  ^^^       # ^^^^          ###                               #  
        ^^^                      ^^^ ^*^       #   ^^            #                               ## 
        ^^^^^                    ^^^^^^^^^     ##               ##                 ~             ## 
            ^                     ^^^^^        ##      ####     ###                #~           ##~ 
        ^^^^^                      ^^^^        ######  # ##     ###               ~##           ##  
        ^^^^^                      ^^^^          ## ######      ~###               ###           ###
        ^^^^                        ^^*            ######       *###               # #            ##
        ^^^^                            ## ####    #####        ^^^^               ###           ## 
          ^^                            ####  #                 ^^^^      ^^^^                   ###
           *                            #####               ^^  ^ ^^^     ^^^^ ^^                  #
                                        #####               ^^^^^   ^   ^^^^^^^^^^^^              ##
                                        ###     ##         ^^       ^^^ ^    ^^ ^^^^              ##
                                                ####       ^^^^       ^^^     ^^^^^^    ######    ~#
                                               ### #       ^^^^              ^^^^^      ###  #######
                                              ## ###       # ^^              ^^                ##   
                             ^^            ####   ##       ####               ^^                    
                             ^^^           #####         ######                ^^^                  
              *              ^^^          ######         ######       ^          ^                  
              ^^              ^^^ ##      # ###          ######   ^^^^^         ^^                  
             *^               ^^^ ###     ###           ##   ##^^ ^*^^^         ^^     *            
              ^^     ^^^     ^^^^   #      ##                 *^^ ^ ^^^            ^^^^^            
              ^^   ^^^^^ ^^ ^^ ^^   ##                ^^^^^ ^^^^^^^                ^ ^^^            
              ^^^  ^  ^^ ^^^^^^^^    #      ^^         ^^^^^^^^^^^^                ^ ^              
              ^^^^     ^^^   ^^^^    ##    ^^^ *       ^^^^^^^^^^^^              ^^^^^              
              ^^ ^                    #   ^^ ^^^^        *  ^^  ^^^              ^^^^^              
              ^^ ^    ####           ##   ^^^^^^^                                ^^^^^              
              ^^^^    ####         ###    ^^^^^^^^                              ^^ ^^               
                    ######^      ###        ^^^^                                ^^^^^^^             
                 # ##  ## ^      ~ ~                                            ^*^^^^^             
                 ###     ^^                                                    ^^   ^^              
                         ^^                                          ##        ^^                   
                          ^            ^^  ~                        ~##         ^                   
                        ^^^   ^^      ^^^  ###          ###         ##          ^^^                 
                        ^^  ^^^^      ^^^   ##      ##  ###         ####         ^^^^               
                      ^^^^^ ^  ^^^^  ^^^^ #####~    ##   ##         ####~        ^^^^               
       ^^^^      ###  ^^^^^ ^^^^^ ^^^^    ######  ###### ##         ####           ^^               
       ^ ^^     ####  ^^^^  ^^^ ^^^       ######  #########                           # ~           
       ^ ^^     ###   ^^^^  ^^^^^^^         ####   ##  ###                            ###           
      ^^  ^       #   ^^^^ ^^^   ^^                #   ###                              ##          
      ^ ^^^       ###      ^^                     ##                                   ###          
      ^^^^         ##       ^                    ~##                                  ##            
       ^ ^^                 ^                      #                                  ##            
       ^  ^^                                      ###           ###                    ###          
 ^^^^^^^              #                           ###           ##                    ####          
 ^^^^^^^^^            #                           ~  ^^^^^^     ##                    #             
^^^^^ ^^^^            #                           ^^^^^^^^^     ##                   ##             
^   ^^^^^            ##                           ^^^^^ ^^^                        ###              
^^^^^ ^^^            #   ##                       ^^^^^                           ##                
 ^^^^^^             #### ####                       ^^^^^^             ^^^^       #                 
 ^^^^       ####    #############           ##         ^^^             ^^^^^                        
  ^^^       ####       ##   ## ##         ####~        ^^^^^            ^^ ^^                       
        ##  ####            ## ###        #### *^^*      ^^^      ^^ ^^^^  ^^                       
        ### ##~                  ###   ## ###  ^^^^             ^^^^^^^^                        ### 
        # #                        #   ####### ^^^^             ^^^ ^^^^                        ### 
       ## ### ##                   #   ##  ### ^^^              ^^^^^ ^^                        ##  
            #####                  #    ##  ##^^*^^                 ^^                          ##~ 
             ## #                        #    ^^  ^                  ^                        ###   
             ####                             ^^^^^                  ^^                       #     
             ^^##                             ^^^                 ^   ^                 #######     
            *^^  ^^                           ^^                  ^^  ^                 ###   ~     
            ^^^^^^^                                               ^^ ^^  ^^^            ###         
            ^^^^^^^                      ^^^                     ^^  ^   ^ ^^^          ###         
              ^^ ^^                      ^     ^^                ^^^ ^^^^^ ^^^                      
                 ^^                     ^^^^^  ^^^  ^^             ^ ^^     ^^                      
                                        ^^^ ^^^^^^^^^^^^^          ^^^      ^^^^                    
                          ^^^*                ^^^  ^^^^^^         ^^^^      ^^ ^                    
                         ^^ ^                  ^^  ^^^^^          ^^^^^^^      ^^                   
                           ^^                      ^^               ^^^^^^      ^^^                 
                           ^^                                       ^^ ^^^     ^^^^                 
                                                                     ^^^^^   ^^^^^                  
                                                                     * ^^^   ^                      
                                                                            ^^                      
                                       ^                                    ^^                      
                                       ^                                    ^^                      
                                      ^^                                    ^^                      
                                      ^^^^                                                          
                                      ^^^^                                                          
                                      ^^^^                                                          
                                     *^^                                                            
                                                                                                    
                                                                                                    
                                                                                                    
                                                                                                    
