            ^^^                                   
          *^^ ^^^                                 
               ^^                                 
               ^^                                 
              ^^^                                 
            ^^^^^                      *^^^       
            ^                          ^^ ^^^^    
            ^^              ^^              ^^    
           ^^^*             ^^  ^^^         ^^    
                           ^^^^^^ ^^              
                           ^^^^^^^^^              
                           ^^^^^ ^^               
                              ^^ ^^               
                             ^^                   
                             ^*                   
             #~             ^^^^^^                
             ##~          ^^^ ^^ ^         ^^^    
             ##           ^^             ^^^^^    
             #            *^^            ^^ ^^^^  
        *                   ^             ^^^^^^  
        ^^^                 ^^            *^^^^^  
        ^^^         ##       ^                ^^  
       ^^^^         ##                   ^        
                    ##                 ^^^####    
                    #                  ^  ~  ###  
                    ###                ^^^ ^   ## 
                      #~             *   ^ ^    ##
                     ~#             ^^^^^^ ^    ##
                      ##~           ^^^^^^^^  ### 
   ^^^                 ###           ^^^^    ~#   
   ^^^                                        #   
   ^^^                                        #   
  *^       ~~                                     
  ^^       ##                 ^^^^^               
  ^^^       ##                ^^                  
  ^^^^^     ##                ^^^^                
    ^^          ^^^^          ^^^^^               
    ^^          ^^^^^          ^^ ^               
                  ^^^          ^^^^##             
                ^^^^^^          ^^ #              
                     ^          ^^ ##             
                     ^^             ###           
               ^^^^^*^^##             ###         
              ^^^^ ^^^ ##              ##         
              ^^^^      #              ##         
                ^^    ###                         
                      #                           
                      #~                          
                    ### #                         
                    #####                         
