                                                                                                    
                                                                                                    
                                                                                                    
                                                                                                    
                                                                                                    
                                                                                                    
                                                                                                    
                                                                                                    
                                                                                                    
                                                                                                    
                                                                                                    
                                          ###                                                       
                                         #######        ##                                          
                                         ##### #        ##                                          
                                         ##~   ###  #######                                         
                                       ^^        ####  ##      ####                                 
                                      ^^^^^      ##           ~#####                                
                                      ^^^^^             ^^ *   ### ####                             
                                     ^^^^^^^^^      ##  ^^^^   ##   ####                            
                                    ^^     ^^^      #~ ^^^^^^^ ##    ###                            
                                  ^^^        ^      ###^^^^ *^^##### ##                             
                                            ^^    #####            ####                             
                                            ^^    ##              ######                            
                                          *  ^     ##            ~######                            
             ###                          ^^^^      ##    ^^    ###  ###                            
             # #                          ^^##       ##   ^^^^^^##                ^^                
           #####                            ######  ###   ^^ ^^^ #                 ^                
           #  #                              ########      ^^^^^^                 ^^                
        ####  ###           ~##                ##  ##       ^^^^^         ##      ^^                
        ####  ###            ##                            ^^ ^^          ##       ^                
           #   ##            ####                          ^  *          ####      ^^               
                              ###                         ^^ ^^^^        ####                       
                              ###~                        ^^^^  ^^         ##                       
                              ###                       ^^^^     ^^      ~                          
                              ###                       ^ ^^    ^^^^    ~##                         
                              #                         ^^^^   ^^^^^     ##~                        
                                                         ^ ^  ^^         ~#~                        
                                                         ^^^  ^           ~                         
                                                              ^       ^^^^                          
                                                                      ^^ ^^^^^                      
                      ^^^^^                                          ^^^ ^^^^^                      
                   ^^^^^^ ^^^^                                      ^^     ^^*      ^^              
                   ^^^^^^*^^^^                                      ^               ^^ ^^           
         ##~   ##  ^^^^^ ^^ ^^          ^                          ^^               ^^^^^           
          #######  * ^^^^^              ^                       ^^^^*              ^^  ^^           
          ### ###    ^^                 ^                       ^ ^^               ^^^^^^^          
          ### #               ^^^^     ^^                       ^^                 ^^^^^^^          
           ####               ^^^^^^^  ^                     *   ^^                ^^^              
           ###                 ^^^^^^  ^                   ^^^    *                ^^  ^            
          ########            ^^ ^^^^^^^                   ^^^^^                    ^^^^            
          #####~##            ^^^^^                    ^^^^^^^^^                    ^^              
          ~ #####             ^^ ^^                 *^^^ ^^ *^^^                                    
            ####                                     ^^      ^^^                                    
                                                    ^^^      ^^^                                    
                                                    ^        ^^^                                    
                                                  ^^^                                               
                                                  ^                                                 
                                                                                                    
                         *^^ ^^^                                                                    
                         ^^^^^^^                                                                    
          #              ^   ^^^                    ^^^                                 ##          
          #                  ^^^                    ^ ^^^                               ##          
       ## ####               ^^                    ^^ ^^^*                             ###          
      ########                                     ^^ ^^^                              ######  ##   
      # ##  ##                                      ^                                   #########   
      ####~                                        ^^                                   #########   
       ####                                      ^^^                        ^^^          ## ## #    
       ~  ###                                    ^                          ^^^          ~~  ###~   
            ##                                   ^^                      ^^^^                       
           ###                                  ^^^ ^^                   ^^                         
           #                                  ^^^^^^^^                   ^^                         
          ##                                   ^^^^ ^^^^                 ^                          
         ##                                     ^^^^^^^^                ^^                          
         #     #                                 ^^^^^^^                ^^^^^                       
        ###### #                                 ^^^  ^                   ^^^^                      
        ###  ###                                   ^^^^                   ^^^^                      
                       ^^^                         ^^^^                                             
                      ^^^^*                        ^^^^                                             
                     ^^^^^^^^                                                                       
                     ^^^^^^^^                                                                       
                      ^   ^^^                                                                       
                                                *^                                                  
                                              *^^^                                                  
                                               ^^^                                                  
                                               ^^^                                                  
                                             * ^                                                    
                      ^^                     ^^^^                                                   
                      ^^                     ^^^^                                                   
                      ^ ^^                   ^                                                      
                      ^^^^                                                                          
                        ^^                                                                          
                       ^^                                                                           
                       ^*^^^                                                                        
                       ^^^^^                                                                        
                          ^                                                                         
                          ^^^^^^^^^^                                                                
                          *^^  ^^^^^                                                                
                           ^^    ^^^^^                                                              
                                     ^^                                                             
                                  ^^^^^                                                             
