                                                                                                    
                                                                                                    
                                                                                                    
                                                                                                    
                                                                                                    
                                                                                                    
                                                                                                    
                                                                                                    
                      ^^                                                                 ##         
                  ^^  ^    ^            ^ *^                                             ####       
             ^   ^^^ ^^    ^    ^ # #  #^##^  ^^  #      ^^  #^^^ #     ^ ^ ^      ~ # ######       
               #^^ ^^^^  #^#    ^ #^^ ^  ^ #           ^ #      ^#^ ^    #   ^   ###   #   ##       
           ^   ^^^^  ^#  ^^  ^ ^ #   #    *^          ^ ^^    ^ # ^  ^           #  ^^^  #          
            ^  ^^^^   ^ ~#       ^  ^      #  ^^^ #   #         #     #^ ^    # ^  #                
            ^ #^^^^         # ^  ^  ^  ^^ ^^     ^##    ^^^ ^ #        ^        ^   #^  #^          
               ^  ^    ^^     #            ^        #  #        #^   ^ ^   ^       ^ *  ^#          
           # ##^^   ^ ^ ^ ##         #  ^ #     ^#     ^  # ^# #       ^ # ^ ^#  ^ #^  ^#^          
              ^^ #  ^      ^^ #        #   #   ^^       ^   #    #              ^      ^            
                 #            ^^#   # ##        ^     ^ ^      # #   #    ^^^ # ^                   
          ^#  ### ^ ^    ^      #   #   #   *^  #  ^ ^^ ^^    ^   ^   ^^  ^  ^ *^   #               
          #     #  #      ^  #  ~#      ^^^   #        ^  ^          ##   ^^ ^  ^  ^^  ^            
               ^   #^    #         ^     ^   ^ ^   #  #              ^^ ^    *# ^^ ##^              
          ^^^^# ^  ^          ^#  #^  ^    ^^^     ^^  ^ ^    ^    #  ^ ^#^  #   ^#   ^             
                         ^ # #^      ^^#    ^   ^        ^#          #        ^    ^                
          #         #^^^ ^            #        #  #   #^^    ^     # ^#      ^  ^#  #^#             
          ^      #  ^ ^     ^       ^^# ^^ ~#     #     ^^ ^    #    ^  #    #  *#^^  #^            
          ^^ #  ^^ # ^     #       ^#     ^                     # # #     #     ^  ^  #             
          #^^        ^          ^  #    ^^#^^^  #      ^ ##  #   ^ ^      #^#      ^#  #            
               #       #           #  #    #  #  #         ^^    ^    ^^    #  ^^^                  
            ^^      # ##   ^  ^    ##       ##            # ^  #  ^^^^    ^   #^# ^  ^              
           ^ #  #^  #^         ^        ^ #        ^ ^^  ^^^  # ^^     ^     ^^     #               
            ^   ^    ^        ^^  ^    ^     ## ^  ^ #    ^   ^  ^^^       #^* ##    ^              
            ^ # ^#   #^   #     ^ ^^#^^* # #        #  #  ^ ^^^^ # #     ^ #^    ##  ^              
           # ^^^ ^  ^   ^^^         #^^      #^             #  ^^  ^^   ^#    # ^  *^ ^             
           # ^  ^      *^^^ # #^^#     ^  ^   #  ^^^# #^^      ^  #      #        #^# ^  #          
                ^       ^^^       #^   ^          #^ #~     #^    ^       ^    ^  ^  ^^^            
           ###   ^ #  # ^^     ^                 ##^^~# #   ^^    #    ^#    ^ ^^ ^  ^  ^           
             # ^^ #  ^          #             ^^         #      #    ##^    ^#^^     ^  #           
             ^#   ~# *^#   ^^^^# ^^#    ^   ^    ^             ^^       ^   ^ #     ^^ ^            
          ## #  ^#    ^   ^ ^     ^^ #      ^   # ^#^  ^ #            # ^#  ^   ^  #  ^             
            ^^  #    #^# #          ##^     ^  ^ ^              ^ #    ^        #        #          
             # #^     #^# #    #^  ^^#^ # ^^ ^#^    ^# ^# #    #^      # ^^^   #      ^ ^^          
             # # ^^##  ^   ^      ^           ^     ^^^^     ^## ^^^  ^^ ##^#^      ^               
               ^     ^   #~ # #   ^^      #^  #          ##    ^^      ^   # ^    # ^ ^#            
             # ^#    ^   ^^  ^ ^^^  ^^^^#             #   ^^       ^   #  ^     ^   #  ^ #          
          #      #  ### ^^ ^      #  ^         ^ ^^ #^ ^  ^^^ ^ ^  ^      ^     ^   ^   ^^          
          #^ ^ ^ #   ~ #         ##       # #^ ^  ^ # #^    ^  ^#  # #                              
           ^  ^^  ###     ^  #             #  ^^     #    # ^       #  ^ ##     # #  ^              
             # #^^       ^    #^^^     ^  ^ ^^  #  ^          ^^^    # ^  # ^^^^   ##  # #          
            ^        ^          ^# #^^ ^  ^^      #    ^          ^      #   # #  ^      ^          
          ^     ##   ^#    # #^^ #    ^ ^  ^    ^ ^     #      #    ^   #  ^      ^   # #           
          ^                  ^   #^ # ^ ^^     # ^##~ #       ^ ^^#    #   ^ #  ^   ^ ^             
               #        ^  ^ ^^# ^^  ^  ^ # ^#        #   ^#   ^ ^ ^        ##^^ #                  
            # # #       ^^^  ^^  ^^  ^               # #  ^   ^#          ^ #~  # ~# #              
           ^#  ^            #   ^^ #   ##   #^     ^^  # ^ ^  ^##^# ^^           ^##   ^            
           ^  ^        ^   #    ^    ^   ^   ^  #  #^      ^   ^          #         ^  ^            
              #^ # # ^                    #      # # #  ^^  ^^        #     ^^     #   ^            
                # *#^     ^^^     #          #    #      ^  ^^        #  #^ ^^      ^  ^            
          # #   # ^^     # #    ^^#              ^  #  ^^#   ^^ ^  ^ #    ^ ^^^^^#   ^ ^^           
                     #   ^     ^                 ^#   #   ^    ##  ^^     ^ ^^ ^^^^                 
                        # ^^   ## ^#        ^^ # ^   ## ^^^^        #    #   ^^^ #^ ^ #  ^          
            #  ^  ## #    # ^             # ^^^#   ^ ^ ^^ *^^   ^#   #  ## #   ^  ^^ ^   ^          
              ###   ^#    # ^^ #    ^   ^      #         ^^ ^##  #           # ^  #  ^              
          ^^^      #  #         ^ ^^^       # ^ # ##         #    ^  # #  # ^^#      ^ ^^           
           ^  ^   # ^      # #    #  ^ ##    #  #^  # ^      ^^ #    *^ ^^#         #               
           #  ^   #  ^  ^ ^^     ^ # #     #    #   ^       #^    ^^ ^^  ^^ #   ^ ^ #               
          #      # # # # ##^   #  ^^    #      ##  ^  ^^^     ^^       ^# # ## ^   ^    #           
          ^          ^      #    #   ##         # ^ #    # #^ #   #     ~   #  ^ ^# ^^   #          
              #^   ^       ^^                   #        ^      ^ # #~  ^  #    # ^ ^^  ^           
               ^    ^^     ^        ^#^            #            #      ^        ^  ^ #   ^          
            ^^  ^    ^ ^^^  ^ #  #    #            #^ #       ^^      ^         ^  ^  ^^ ^          
           ^## ^^     ^^ ^^          #^    #  ##    ##        ^  ^^# ^  ^ # ^   #                   
              #^  #^^^ ^  # ^^^   ^ #^^   ^      ^           #     ##^ ^#   # ^ ##^                 
           ^   ^#    ##  ^    ##      ##         ^ ^ ^#         #      ^^     *^#   #  # ^          
           ^   ^       #  ^ ^ ## ^#  ^^                  #       #    ^        ^ #       ^          
                        ^^ ^ ###     *       ^   ^  #             ## #^ #    ^        #             
               #  # ^      ^  #^    ^^^#     ^    #^^  ^^ ^   ^  ^     # ^^          ~#^^           
          ^   ^^ ^^               #^      ^#       # #   #  ^^^^^ ~ ^ ^^# ^      ^ ^                
           ^     ^       ^  # #       #     #^ #^# #^       ^^ ^^ ##^   #        ^  ^^#             
          ^      #  ^ #   ^ ^ ^      #      # ^      ^^   ^# ^^        # ^    #     #^ ##           
          ^                 *   ^ ^         ^  ^^     # # ^  ## #^^      ^ #   #    ^  ^^           
              ~^   ^#     #      ^^     ^ ^^^ ^    #   #  #^^#   ^  #     ^^         ^ #^           
              ##  #     ^^          # #   ^ ^^  ~  ^ ^  #  ^   ##^ ##    ^^   ^ ##   #  ^#          
              ^  #    ^^     ^  ^^      #      ^#  ^   ^^^   ^^    #      ^^^       #   #           
           #    ^ ^^^   ^^ ^*^         ^^   ^^  ~^         #     ^         ^      ^#                
              ^^^^^ ^      ^^              #   #    ^ #     #    ^^^ #  #    ^^ #       ^           
           ^    ~   ^^ ^^  ^^                ^#^      ^^      #  #^    #    ^#  ^  ^                
            ^^ ## # #       ^ ^   #     ^  ^ ^ *^    ^    # #   ^ #     #  ^    #    #              
             #^#    #^   # #  ^      ##   #   #^^ ^^#^  ^ ^^^   ^ #  ^#    #    ^^^  #   #          
                ## # ^ ^   ^   ^    #^   ^^     ^   ^   # #              #    ^        #            
                                                                                                    
                                                                                                    
                                                                                                    
                                                                                                    
                                                                                                    
                                                                                                    
                                                                                                    
                                                                                                    
                                                                                                    
                                                                                                    
