                                                                                                    
                                                                                                    
                                                                                                    
                                                                                                    
                                                                                                    
                                                                                                    
                                                                                                    
                                                                                                    
                                                                                                    
                                                                                                    
             ^  ^^   ^## #^#  ^   ^#      #   ^#   #^^#                ##^^        ^    #^          
          ^  #      #^    ^#  ^ ^          ##^^     ^^ ^     #     ^      ^        ^#    ^          
           ^ ^    ^ ^     ^ ^ ^#^  #       ^#  #        #    ^^ ^ ^  #          #        #          
           # #   ^  ^   #   ^## ^  ^^         #    ^         ^^~      ^^  ^   ## #    #             
             ~ ^#^    #       ^^^ # ^      ^#  ^#              #  #          #     #     ^          
             # #^^#^#  ^   ^ #  ^  ^   # # # ^ ^                       ^     ^   ^##   ^^^          
             ^ #^^^^ #   ^^    ^      ^^    ^^ ^ ^         #   #  ^    ^#   ^ *^   ^   ^ #          
                #  ^    ^  ^ # ^ # ^   ##   *    ^# #^ #      ^ ^^#     # #^^    ^#^   ^#           
          #    #   ^        #   ^^    ^ # ^   ^^#   #   ^         #      ^##   #    #  ^            
             ^          #    # ##     ^^^#  ^^##  ^^ #  ^  ^ ^     ^ ^^   ^^^^          ^           
          # ## ^^   ^^     ^  ^        ^ #    ^^   ^^   ##       #^^##  ^#    #      ^  #           
            ##     #^^^^^#^^         ^  ^              #        ^^^ #         #    #     #          
           #       ^    ^  #^         ^       ^    ^# ^  # ##     ^ ^ ^  ##   ##~#    ^             
           #       ^  ^   ^ #     ^ ^^    ^ ^   #   ^~   ^#    ^# #       #         #   ^           
          #    #   ^  ^    #     #*  ^  #   ^ ^ ^#   #     #   #   ^          # #    #  ^^*         
                  ^  ^^^   ^   #   ^*^^^         ^^^^             #^          ^  #   ^   ^^         
              ^          #  ^         ^^ ^ ^ ^ ^        ^ ^^ # #      ^        ###  # #^ #          
           #  ^       #      ^#      ^^      ^    ^                        #  # ^   ^  ^ ^          
           #   #     #    #^^^       ### ^ ^  ^^  ^  # #    #      ^^ #  ^ ^  #     ^^ ##^          
                  ^^^     #^  #  ^     ^ #  *^         ^^     ^#  #^     ^#    ^   #     ^          
             #    ^# ^^ ^ ^     #^      #  #  ^   #  ^^    ^^  ^#    ##      #   ^  #    #          
            ^^    #~ ^^ ^##   ^# ^   ^^     ^^   #         ~      ^          # ^^  ^   ^            
           #^ ^^   ^^  ^  #           ^ ^  ^     #^     ^  #      ##  ^^#      ^  #    ##           
          ^      #    #       ^#^   #^     ^  #^   #  ^  ^   #^  ^^  #^^^^  #  #   #  #             
           #       #               ^ # # #^^   # #    ^        # ^^^^^^  ^^   ^ #^^ #               
                       ^ ^^    #   ^^#    #           #  ^^    # ^^^^^^ #   #^     #    ^           
                ^  #^  ^           #^       ^^^^ #   #    ^   ^      # # #       ^   ^^^ #          
          ### #^^      ^       #      ##     ^^          # ^#        ### ^^    ^      *^^^^         
           #       #      #      ^ ^      ^#  ^            #  ^^  #    ^^            ^^             
            #   ###  ^  #     ^^      ^^ ^^    #  #  # #       ^ ^^# #   ^^ #^#   # ^   ^           
          ^   ^#    ^^        #^  # ^^ #  ^^ #   ^ #  #     ^#^^^ ^#   #^^  ^#  ^^#^^  #^           
               # ^^   #  #   ^^   #  ^ #  #    # ^    ^^^ #    #  ^      ^     #   #                
              ^## ^ ##   ^   # ^   #    # ^^                #    # ^ #    #      #  ^  ##           
           ^      ^     ^   #     ^       #     #     ##      *## ^^  # # ^ ^^      ^   ^^^         
              ## ^  #^^    ^     ##      #^  #^^         #^   ^#^  ^    # #   #   ^  ^ ##^*         
          ## ^# ^  # ^^^^^  ^^     ^^         ^             ^     ^^      ^#^     ##^### ^          
            ^ ##^^ ^^^ ^^^^  #^^ ^^^ # # # #  #  ^    #  ^ ^  #^ ^#     ## # ^^ #     ^*            
           ^^    ^ ^^  ^^^^ #^^  *^^  ^  #  #  ^  # ## #   ^      ^      ^    ^    # ## #           
          #  ^     ^^ #^^^^   ^ ^^^   # ^    ^^  # ^^#     ^  ^#   # ^ ##~ #     ^^#^^  #           
            #^ #   ^             ^^   ^         ^ ^   # *  #  ##^  ## #  #  #  # ^^#^# ^^^          
                  ^ ~#   #       ^#         # #      ^^ ^  ^        #    ^ #~^#  ^  #^^  ^          
           ^  ^*    # ^         ^    ^       #    #     ^         #  # #  ^^ #      ~   ^^          
           ^    #   # ^# #      ^    #      #         ^  ^    # #    #   ^ #   ^     #  #           
               ^^            # #       ^ #  #  #       ~#   ##  # ^ ^    ^     ^         ^          
               ^^       # ##    #  ^      #         ^  ^  ^^ ^^^  ^    ^   #        *^ ^ ^          
            ^   ^    ^  # ^^ ^#^ ^^   ^^ ^ # # ^    ^ #      ^           ^   ^ ^^   ^^  #           
          ##  ^  #   ^#^    #^   ^  ^     ^^   ^^    ^^    ^^          #^^^ #^ ^^#  ^               
          ^^     #^^#  ^ ^   ^ #  ^   ^^#  # #^^      ^^ ^   #  #       #  #   ^                    
               ^    #^#   ^^#    ^^   #^#^ ^#              ^       #  ^  ^^~                        
          ^    ^          ^# ^ # *^^    ^#^  *           ^ ^      #     ^       #    #  #           
          ^ ^  #          ^   # ^# ^      ^# ^^              ^  ^      ^^#    ^  ^    #^            
            ^^#  #^#   # ^^   ^   ^    #    # ^#^^          ^^#   ^   # # #  ^        ~             
             # ^# ^##^ ^^  ^^       ^      ^^ ^^  ####^#^^    ^  ^     ^    ## ^ #  ^   #           
               ^   ##  #       #   ^ #     ##   #      ~    ^   ^^#         ^ ^^#      ^            
          ^  ^^ #   ~#^^^      #     ^   # ##    #     #      ^     ^^ #^  ^## #^  ^  ^^ ^          
             #     #  ^##      #     #    ^          ^     ^    #         ## #         # ^^         
             ^^^#  ~# #    #^^    ^^#     ##  ^          ^ ^      ^    ##    #    ^ ^   ^           
                  #   ^###^#^^    ##^^ #   ##   # ^     ~##^^#    #  #   ^ ^# ^   ^^ ^^^^           
            ^~##    ^^ ^    #  ^^   ^      # #  ^^^# #  ^#  # ^^  ~      # ^      #  ^  ^           
              ^  ^  ^    ^^    #    ^     ^^  ^^   ^     ^       ^^   ^   #   ###                   
           ^^^^      ^   ^^           #   #^^            #          ^    #   #        #             
           #      ^     # # ^   ^ ^^#  ^^ # #    ^                      # ^^#^        ^^            
         ^^^     ^^        ^^ # #     ^      #   #  ^^   #    ^      ^ #  ^^ ^ ^      ^             
         ^^#    #           #        #^       #  # ^# #   ^^  ^#           ^     #^# #^ ^           
                       #  ^^      #        ^^     ^^         ^     #  ^        #  ^     ^           
           ^         #       ## ^^     #^       ^^^   ^    #^  ^   #   #^#      ^ ^^    ^^          
           ^       ^^ ^ ^^     ^ # # #  ^ #      ## ^       ^  ^ #    #  #  # #       ## ^          
          #     ^   #   ^    #    ^^        #^  # ^ ##  ##  ^#    #      ^^    #                    
                ^  #^  ^  ^  ^ ^ ^            ##  *        # ### ^##   ^#    # ^#  ^ # #            
          *^^^#       # ^   ^^ ^^    ^^^ ^  ^^   ^^       ^ # ^   #    *# ^^^ ^    ^  ^^#           
              #      ^  #^ ^^ ^  ^^^    #^ ###^^^^   #     #    # ^    ^  ^      ^ ##   #^          
          #      #    ^  ^ ^  #  ^  #  ^    ^   ^^^^ ##   #  ^^ ^      ^ ^     #     # ^^^          
           ^      ##^  #       #     ^     ^  #^  ^ ^    #    ^^# # ^    # # #      ^ #             
          ^#  #    ^^^^    ^##    # #^  #    ^^ ^ ^   ^   ^    #^  ^# ^^^  # ^   # ^  ^  ^          
               ^  ^    ^^^^   # #    #  ^  ^ ^  ## ^ #^     #  ##     ^#  #  ^          #^          
           ^ ^  # ^    ^   # ##       # *### #     ^        ^    ^ ^^ ^~ #  ^   #                   
          #  ^            ^^     #  #    ^ # # #    #    #   ^^ ^  #  # #      #  ^#                
           ^  #  #  #       ^^^          #   ^^ ^  ##   ^^      #^ ^ #        ^ #    #              
           ^^^   ^^^ ^ ^    ^ ^ #^   #   # ^  ^^^ #    ^  # ^ ^^    # #      ^^ ^  ##               
                              ^         ^         # #          ^^       ^  ^^       #               
                                                                                                    
                                                                                                    
                                                                                                    
                                                                                                    
                                                                                                    
                                                                                                    
                                                                                                    
                                                                                                    
                                                                                                    
                                                                                                    
