                                                  
                                                  
                                                  
                  *                  ^^^          
              ^^^ ^^                *^^^          
            ^^^ ^^^^^                ^^           
            ^^   ^^^^                ^            
             ^^^^  ^                ^^            
           *^^^                                   
            ^^^                                   
                                                  
            ###                                   
            #~#~                                  
            ###                                   
                                                  
                                                  
                                                  
           *     ^^                               
           ^^^^^ ^^        *^^                    
           ^ ^^^^^^^^^   ^^^^                     
          ^^    ^^^^^^  *^^                       
        ^^^       ^ ^^    ^^                      
         ^^       ^^^^^   ^^   ~                  
         ^^         ^^^    * ###                  
                    ^^^      ###                  
                    ###~    ####                  
                    ###     ###           ^^^     
  #                 ~##     ~##          ^^ ^     
  #                 ##                    ^^^     
 ##                ~#                 #  ^^       
 #####              ~   *^^           #~ ^        
   ##                    ^^           ##^^*       
                         ^^            #^^^       
                         ^^            # *^^^     
                                           ^^     
                                ^          ^^     
                                ^           ^     
                                ^^^         ^^^   
                                ^^^          ^^   
               #                 ^^          ^    
               #~                                 
               ###        ^^^                     
                          ^^^           ^^^       
                           ^^^          ^ ^^^     
                           ^^^^   ^^    ^^        
                            ^^^^^^^^    ^^        
                            ^^^^ ^^^^^^^^         
                                     ^^           
                                                  
                                                  
